x,y,add_xy,a,b,subtraction_ab,c,d,multiply_cd,e,f,division_ef
132,362,494,147,22,125,452,453,204756,244,431,0.56612529
333,324,657,227,437,-210,192,129,24768,73,105,0.695238095
370,314,684,189,448,-259,302,407,122914,96,95,1.010526316
284,372,656,390,226,164,402,182,73164,206,443,0.465011287
480,48,528,351,436,-85,327,395,129165,264,166,1.590361446
90,476,566,495,54,441,419,420,175980,197,304,0.648026316
138,268,406,326,488,-162,69,276,19044,444,283,1.568904594
78,425,503,171,170,1,107,249,26643,402,93,4.322580645
196,247,443,304,264,40,411,310,127410,482,163,2.957055215
80,145,225,328,118,210,487,145,70615,16,278,0.057553957
93,323,416,251,328,-77,174,355,61770,463,34,13.61764706
441,38,479,179,198,-19,56,330,18480,338,447,0.756152125
13,194,207,48,421,-373,343,123,42189,284,493,0.576064909
180,61,241,384,193,191,175,448,78400,451,152,2.967105263
194,108,302,269,282,-13,105,43,4515,282,350,0.805714286
134,192,326,466,380,86,57,234,13338,69,167,0.413173653
281,18,299,216,341,-125,161,81,13041,262,110,2.381818182
418,309,727,191,362,-171,271,68,18428,393,328,1.198170732
321,71,392,331,94,237,188,483,90804,417,44,9.477272727
56,139,195,383,249,134,108,457,49356,382,116,3.293103448
207,416,623,394,63,331,335,222,74370,88,237,0.371308017
392,338,730,223,134,89,207,292,60444,39,124,0.314516129
286,10,296,31,14,17,163,296,48248,121,36,3.361111111
439,270,709,32,200,-168,51,480,24480,412,356,1.157303371
331,469,800,131,108,23,361,300,108300,338,92,3.673913043
330,496,826,414,340,74,343,213,73059,61,300,0.203333333
157,306,463,481,467,14,472,468,220896,399,465,0.858064516
437,442,879,411,411,0,248,114,28272,393,168,2.339285714
263,44,307,114,172,-58,500,134,67000,283,358,0.790502793
234,98,332,249,135,114,12,193,2316,44,148,0.297297297
432,309,741,171,385,-214,493,307,151351,481,210,2.29047619
307,278,585,269,122,147,29,408,11832,50,467,0.107066381
165,468,633,500,322,178,316,152,48032,258,97,2.659793814
322,493,815,352,10,342,330,95,31350,457,403,1.133995037
36,329,365,444,246,198,56,91,5096,179,196,0.913265306
44,121,165,335,302,33,147,333,48951,135,325,0.415384615
437,370,807,222,133,89,197,390,76830,323,176,1.835227273
368,298,666,268,251,17,50,462,23100,448,172,2.604651163
70,146,216,386,310,76,279,50,13950,141,484,0.291322314
301,79,380,150,266,-116,446,355,158330,485,177,2.740112994
30,239,269,485,104,381,151,358,54058,418,294,1.421768707
65,66,131,190,43,147,353,372,131316,279,24,11.625
20,154,174,35,36,-1,429,396,169884,53,353,0.150141643
360,260,620,359,381,-22,56,280,15680,109,43,2.534883721
259,211,470,14,458,-444,427,223,95221,210,338,0.621301775
421,23,444,460,219,241,442,320,141440,181,311,0.581993569
140,332,472,448,227,221,386,23,8878,233,451,0.516629712
346,312,658,98,118,-20,273,163,44499,395,404,0.977722772
162,329,491,88,496,-408,437,206,90022,343,418,0.820574163
14,475,489,290,137,153,272,413,112336,335,35,9.571428571
395,41,436,178,208,-30,376,340,127840,209,365,0.57260274
435,260,695,160,276,-116,455,217,98735,18,201,0.089552239
333,194,527,348,319,29,325,215,69875,384,425,0.903529412
444,113,557,335,274,61,117,431,50427,63,345,0.182608696
424,423,847,418,164,254,222,346,76812,278,177,1.570621469
151,451,602,393,417,-24,31,364,11284,295,135,2.185185185
435,155,590,107,101,6,478,102,48756,82,78,1.051282051
265,440,705,418,363,55,82,174,14268,241,433,0.556581986
235,118,353,482,121,361,472,12,5664,154,269,0.572490706
385,208,593,329,220,109,39,76,2964,355,244,1.454918033
444,71,515,131,154,-23,445,84,37380,91,360,0.252777778
498,56,554,351,367,-16,338,249,84162,412,60,6.866666667
467,357,824,122,103,19,353,390,137670,436,274,1.591240876
42,393,435,325,454,-129,81,332,26892,488,293,1.66552901
171,132,303,495,391,104,263,311,81793,122,342,0.356725146
22,490,512,325,169,156,202,195,39390,397,400,0.9925
432,360,792,482,209,273,405,166,67230,75,402,0.186567164
259,247,506,325,374,-49,386,188,72568,427,188,2.271276596
492,230,722,288,80,208,220,417,91740,497,275,1.807272727
389,20,409,119,108,11,151,479,72329,359,110,3.263636364
381,410,791,146,397,-251,481,200,96200,423,245,1.726530612
440,147,587,306,298,8,297,451,133947,448,213,2.103286385
164,185,349,348,278,70,31,254,7874,225,252,0.892857143
97,360,457,89,407,-318,226,301,68026,124,490,0.253061224
203,378,581,287,155,132,161,367,59087,356,62,5.741935484
272,370,642,343,376,-33,418,274,114532,120,289,0.415224913
492,31,523,328,368,-40,374,138,51612,401,461,0.869848156
452,329,781,340,163,177,372,80,29760,203,72,2.819444444
333,23,356,481,169,312,156,236,36816,54,352,0.153409091
111,423,534,52,258,-206,274,294,80556,365,495,0.737373737
413,466,879,289,487,-198,124,499,61876,231,316,0.731012658
130,64,194,143,443,-300,159,194,30846,27,443,0.060948081
461,81,542,484,87,397,62,290,17980,19,296,0.064189189
114,71,185,392,74,318,151,74,11174,192,83,2.313253012
497,278,775,42,236,-194,81,25,2025,365,344,1.061046512
227,285,512,436,168,268,427,438,187026,277,31,8.935483871
138,449,587,53,352,-299,378,484,182952,127,446,0.284753363
105,232,337,128,230,-102,223,475,105925,191,90,2.122222222
49,492,541,490,136,354,157,377,59189,334,417,0.800959233
138,89,227,323,371,-48,129,250,32250,347,361,0.961218837
276,16,292,215,406,-191,390,232,90480,226,235,0.961702128
136,376,512,188,277,-89,215,229,49235,323,243,1.329218107
266,149,415,211,127,84,315,131,41265,31,126,0.246031746
364,37,401,263,234,29,498,341,169818,427,270,1.581481481
478,249,727,322,79,243,351,410,143910,110,296,0.371621622
366,423,789,21,423,-402,142,489,69438,367,431,0.851508121
231,29,260,55,470,-415,58,109,6322,450,467,0.96359743
414,476,890,320,462,-142,140,221,30940,248,311,0.797427653
227,185,412,283,413,-130,425,391,166175,375,177,2.118644068
410,11,421,298,12,286,24,438,10512,480,220,2.181818182
113,290,403,414,491,-77,500,63,31500,213,259,0.822393822
403,481,884,463,285,178,262,293,76766,242,328,0.737804878
227,389,616,180,277,-97,415,261,108315,373,149,2.503355705
355,90,445,59,134,-75,494,198,97812,54,55,0.981818182
313,225,538,59,101,-42,256,344,88064,295,499,0.591182365
12,463,475,291,419,-128,187,107,20009,428,255,1.678431373
322,86,408,236,313,-77,353,23,8119,436,280,1.557142857
353,335,688,456,295,161,433,384,166272,454,49,9.265306122
162,195,357,184,50,134,58,417,24186,23,309,0.074433657
165,31,196,385,379,6,388,88,34144,370,480,0.770833333
373,302,675,376,116,260,339,210,71190,253,346,0.731213873
145,260,405,254,231,23,38,290,11020,32,169,0.189349112
252,107,359,378,145,233,481,361,173641,43,409,0.105134474
131,266,397,153,333,-180,95,441,41895,241,204,1.181372549
131,230,361,94,218,-124,330,76,25080,334,146,2.287671233
174,303,477,77,46,31,31,357,11067,438,454,0.964757709
278,489,767,477,180,297,149,289,43061,272,418,0.650717703
130,412,542,166,240,-74,246,165,40590,458,194,2.360824742
437,116,553,84,28,56,370,471,174270,150,417,0.35971223
13,354,367,350,274,76,372,235,87420,115,290,0.396551724
481,370,851,54,290,-236,108,431,46548,156,196,0.795918367
390,369,759,176,175,1,181,168,30408,154,289,0.532871972
423,176,599,356,463,-107,411,402,165222,402,243,1.654320988
217,467,684,447,497,-50,344,426,146544,84,239,0.351464435
113,15,128,137,89,48,151,11,1661,127,95,1.336842105
219,211,430,342,483,-141,232,80,18560,144,301,0.478405316
11,78,89,459,292,167,266,120,31920,409,372,1.099462366
394,76,470,271,48,223,364,454,165256,206,352,0.585227273
189,33,222,218,295,-77,417,453,188901,18,399,0.045112782
268,471,739,328,486,-158,420,264,110880,272,454,0.599118943
77,408,485,167,260,-93,69,242,16698,66,167,0.395209581
32,266,298,177,107,70,230,278,63940,330,414,0.797101449
99,157,256,244,133,111,270,424,114480,458,286,1.601398601
69,110,179,26,321,-295,274,228,62472,382,359,1.064066852
269,384,653,145,192,-47,261,145,37845,194,451,0.430155211
151,403,554,468,412,56,194,395,76630,53,129,0.410852713
321,331,652,69,16,53,107,218,23326,438,295,1.484745763
372,88,460,451,112,339,473,348,164604,38,323,0.117647059
408,283,691,11,311,-300,235,427,100345,372,406,0.916256158
319,344,663,82,344,-262,178,394,70132,270,79,3.417721519
302,330,632,27,168,-141,159,350,55650,170,165,1.03030303
376,400,776,352,239,113,125,47,5875,256,108,2.37037037
200,409,609,261,271,-10,426,389,165714,23,124,0.185483871
461,491,952,264,413,-149,349,296,103304,453,278,1.629496403
74,100,174,243,458,-215,217,81,17577,177,187,0.946524064
333,286,619,259,19,240,417,284,118428,239,168,1.422619048
334,210,544,305,196,109,191,19,3629,266,208,1.278846154
169,327,496,96,24,72,211,493,104023,294,16,18.375
131,139,270,341,42,299,103,311,32033,90,500,0.18
326,332,658,311,227,84,166,465,77190,428,24,17.83333333
495,462,957,346,335,11,332,479,159028,140,22,6.363636364
225,222,447,377,492,-115,296,201,59496,372,410,0.907317073
299,146,445,62,414,-352,409,329,134561,131,443,0.295711061
338,115,453,440,142,298,94,346,32524,440,61,7.213114754
267,99,366,149,55,94,43,452,19436,285,148,1.925675676
182,51,233,210,459,-249,209,467,97603,135,424,0.318396226
247,178,425,126,133,-7,499,195,97305,87,230,0.37826087
239,185,424,17,199,-182,274,372,101928,362,460,0.786956522
40,288,328,352,170,182,482,269,129658,419,124,3.379032258
380,375,755,408,100,308,141,359,50619,356,92,3.869565217
220,64,284,248,105,143,338,388,131144,142,356,0.398876404
291,102,393,348,322,26,23,311,7153,397,363,1.093663912
106,496,602,415,498,-83,316,414,130824,424,172,2.465116279
88,98,186,90,107,-17,113,83,9379,223,393,0.567430025
196,203,399,166,106,60,110,272,29920,482,174,2.770114943
391,107,498,45,69,-24,322,200,64400,102,466,0.21888412
412,437,849,205,383,-178,417,156,65052,56,92,0.608695652
195,209,404,215,290,-75,116,197,22852,371,116,3.198275862
340,60,400,295,131,164,310,128,39680,240,407,0.58968059
117,31,148,11,318,-307,412,29,11948,444,228,1.947368421
492,448,940,76,197,-121,436,103,44908,236,423,0.557919622
32,146,178,146,69,77,115,92,10580,490,410,1.195121951
103,199,302,193,90,103,440,319,140360,438,76,5.763157895
350,399,749,28,250,-222,352,372,130944,96,139,0.690647482
201,484,685,419,216,203,90,488,43920,133,361,0.368421053
259,51,310,222,99,123,211,48,10128,166,289,0.574394464
442,341,783,360,69,291,84,197,16548,370,365,1.01369863
440,413,853,225,65,160,143,281,40183,30,500,0.06
400,226,626,247,302,-55,45,385,17325,468,354,1.322033898
312,323,635,229,396,-167,303,47,14241,379,117,3.239316239
271,482,753,268,463,-195,232,282,65424,267,121,2.20661157
219,151,370,450,25,425,414,440,182160,311,424,0.733490566
217,402,619,27,363,-336,168,74,12432,136,464,0.293103448
363,62,425,373,161,212,481,293,140933,433,131,3.305343511
384,479,863,476,261,215,248,115,28520,484,409,1.183374083
26,251,277,191,255,-64,253,385,97405,84,264,0.318181818
431,394,825,438,246,192,433,389,168437,366,445,0.82247191
252,52,304,94,379,-285,12,422,5064,381,180,2.116666667
35,66,101,27,346,-319,422,217,91574,140,173,0.809248555
420,380,800,314,16,298,353,108,38124,23,400,0.0575
161,301,462,240,482,-242,54,384,20736,276,277,0.996389892
361,19,380,205,369,-164,347,207,71829,371,66,5.621212121
184,215,399,264,238,26,83,84,6972,217,472,0.459745763
311,476,787,390,309,81,168,18,3024,387,371,1.043126685
441,430,871,242,485,-243,275,339,93225,444,163,2.72392638
66,199,265,170,214,-44,242,157,37994,389,290,1.34137931
493,123,616,247,205,42,15,309,4635,284,312,0.91025641
184,374,558,432,353,79,236,373,88028,320,366,0.87431694
125,341,466,364,365,-1,109,302,32918,65,371,0.175202156
413,261,674,277,239,38,394,343,135142,436,340,1.282352941
422,23,445,390,108,282,34,129,4386,243,28,8.678571429
131,159,290,39,346,-307,272,218,59296,42,163,0.257668712
459,23,482,189,290,-101,122,189,23058,62,112,0.553571429
171,239,410,151,155,-4,137,482,66034,61,174,0.350574713
212,310,522,52,346,-294,337,53,17861,207,485,0.426804124
486,116,602,384,156,228,49,227,11123,308,295,1.044067797
214,399,613,95,301,-206,332,165,54780,186,132,1.409090909
486,30,516,452,395,57,73,55,4015,126,281,0.448398577
247,375,622,101,347,-246,199,459,91341,100,78,1.282051282
97,82,179,27,139,-112,104,294,30576,92,136,0.676470588
312,151,463,278,84,194,486,194,94284,276,26,10.61538462
63,336,399,463,53,410,487,133,64771,374,26,14.38461538
460,492,952,281,459,-178,135,147,19845,297,103,2.883495146
366,129,495,391,31,360,435,17,7395,473,217,2.179723502
60,269,329,480,496,-16,61,404,24644,329,215,1.530232558
175,311,486,87,146,-59,107,199,21293,295,286,1.031468531
133,66,199,246,381,-135,427,403,172081,265,35,7.571428571
274,404,678,500,94,406,199,19,3781,158,174,0.908045977
175,270,445,163,380,-217,211,483,101913,117,423,0.276595745
197,224,421,140,494,-354,85,268,22780,449,249,1.803212851
380,349,729,226,126,100,401,25,10025,119,29,4.103448276
151,448,599,211,36,175,137,172,23564,140,79,1.772151899
113,200,313,203,62,141,123,81,9963,130,263,0.494296578
303,21,324,398,61,337,422,258,108876,60,61,0.983606557
441,251,692,150,245,-95,382,82,31324,463,399,1.160401003
301,471,772,248,30,218,435,332,144420,487,205,2.375609756
49,303,352,288,79,209,341,213,72633,186,421,0.441805226
171,119,290,479,215,264,242,192,46464,344,120,2.866666667
357,319,676,351,82,269,483,137,66171,110,102,1.078431373
58,155,213,427,291,136,348,200,69600,335,420,0.797619048
191,171,362,178,326,-148,22,74,1628,475,175,2.714285714
463,43,506,170,414,-244,370,185,68450,483,375,1.288
341,33,374,111,359,-248,151,98,14798,430,159,2.704402516
186,325,511,467,433,34,239,36,8604,310,68,4.558823529
316,399,715,494,138,356,288,57,16416,163,113,1.442477876
84,221,305,338,409,-71,380,289,109820,427,472,0.904661017
197,82,279,421,489,-68,263,141,37083,428,57,7.50877193
289,484,773,456,267,189,382,359,137138,82,217,0.377880184
464,187,651,473,379,94,172,181,31132,377,316,1.193037975
78,43,121,258,33,225,191,280,53480,43,223,0.192825112
111,463,574,396,130,266,106,380,40280,451,198,2.277777778
175,382,557,390,17,373,404,422,170488,338,357,0.946778711
73,73,146,441,170,271,454,124,56296,68,272,0.25
144,58,202,327,213,114,27,271,7317,219,278,0.787769784
40,462,502,94,236,-142,484,49,23716,334,298,1.120805369
190,379,569,475,417,58,418,402,168036,483,159,3.037735849
465,357,822,487,316,171,147,93,13671,268,86,3.11627907
28,84,112,496,172,324,326,412,134312,214,128,1.671875
223,373,596,373,380,-7,102,124,12648,370,38,9.736842105
465,175,640,48,311,-263,438,343,150234,448,495,0.905050505
32,108,140,435,317,118,452,401,181252,157,33,4.757575758
132,300,432,301,237,64,378,237,89586,109,197,0.553299492
341,376,717,39,28,11,189,313,59157,427,451,0.946784922
483,167,650,71,335,-264,403,274,110422,26,384,0.067708333
403,79,482,305,54,251,332,246,81672,212,450,0.471111111
500,14,514,331,325,6,36,440,15840,491,265,1.852830189
37,413,450,160,408,-248,39,437,17043,375,206,1.82038835
423,111,534,321,405,-84,333,44,14652,11,76,0.144736842
325,492,817,61,31,30,142,120,17040,417,318,1.311320755
34,405,439,165,176,-11,473,294,139062,437,347,1.259365994
429,247,676,462,308,154,111,472,52392,487,45,10.82222222
433,107,540,61,433,-372,51,262,13362,226,235,0.961702128
369,370,739,404,476,-72,12,441,5292,91,421,0.216152019
445,175,620,379,443,-64,303,375,113625,257,229,1.122270742
357,238,595,404,431,-27,392,105,41160,395,185,2.135135135
320,42,362,435,158,277,322,99,31878,442,145,3.048275862
372,246,618,265,187,78,426,56,23856,456,459,0.993464052
41,133,174,342,171,171,156,351,54756,55,481,0.114345114
292,335,627,474,365,109,349,481,167869,351,32,10.96875
265,129,394,338,323,15,151,299,45149,270,104,2.596153846
402,111,513,219,181,38,241,169,40729,445,291,1.529209622
38,13,51,372,330,42,320,484,154880,311,383,0.812010444
431,334,765,231,311,-80,200,297,59400,259,399,0.649122807
303,342,645,279,209,70,25,190,4750,488,384,1.270833333
222,224,446,26,252,-226,61,229,13969,391,124,3.153225806
175,333,508,147,105,42,480,62,29760,134,379,0.353562005
151,139,290,361,451,-90,202,228,46056,255,93,2.741935484
372,19,391,269,132,137,384,336,129024,444,26,17.07692308
81,16,97,197,20,177,173,91,15743,62,416,0.149038462
251,236,487,319,255,64,344,207,71208,341,147,2.319727891
294,312,606,273,313,-40,211,470,99170,410,147,2.789115646
339,112,451,11,51,-40,12,245,2940,228,194,1.175257732
193,79,272,474,484,-10,188,61,11468,393,386,1.018134715
388,368,756,479,96,383,295,392,115640,474,283,1.674911661
179,465,644,76,18,58,423,99,41877,220,300,0.733333333
370,287,657,419,461,-42,471,105,49455,477,429,1.111888112
12,485,497,54,203,-149,182,229,41678,466,278,1.676258993
187,445,632,329,44,285,358,72,25776,167,246,0.678861789
360,414,774,105,369,-264,135,249,33615,105,455,0.230769231
486,48,534,359,303,56,147,99,14553,189,464,0.407327586
375,273,648,112,77,35,392,106,41552,327,237,1.379746835
230,411,641,335,121,214,130,391,50830,422,370,1.140540541
95,115,210,177,219,-42,485,334,161990,375,63,5.952380952
331,366,697,282,188,94,94,44,4136,416,92,4.52173913
453,457,910,132,411,-279,362,282,102084,440,342,1.286549708
360,248,608,44,151,-107,85,75,6375,497,460,1.080434783
406,86,492,361,102,259,114,238,27132,459,23,19.95652174
427,145,572,454,23,431,39,312,12168,190,480,0.395833333
17,334,351,305,305,0,58,220,12760,231,101,2.287128713
272,241,513,44,301,-257,169,183,30927,174,200,0.87
215,207,422,379,267,112,264,21,5544,252,136,1.852941176
88,143,231,476,263,213,25,34,850,351,477,0.735849057
77,161,238,304,300,4,467,47,21949,252,494,0.510121457
307,394,701,207,414,-207,485,410,198850,241,46,5.239130435
221,496,717,203,453,-250,444,239,106116,453,250,1.812
449,328,777,346,322,24,66,409,26994,19,391,0.04859335
71,124,195,393,263,130,468,379,177372,264,148,1.783783784
36,392,428,364,365,-1,466,234,109044,368,249,1.477911647
192,351,543,204,66,138,81,49,3969,46,358,0.12849162
458,304,762,479,11,468,114,359,40926,306,350,0.874285714
394,444,838,15,145,-130,456,336,153216,274,499,0.549098196
196,413,609,70,434,-364,205,264,54120,68,302,0.225165563
229,107,336,296,283,13,390,381,148590,322,305,1.055737705
497,91,588,122,397,-275,406,130,52780,483,204,2.367647059
268,51,319,284,98,186,50,409,20450,184,202,0.910891089
303,310,613,123,136,-13,397,443,175871,26,475,0.054736842
407,465,872,497,290,207,485,170,82450,158,132,1.196969697
342,346,688,149,454,-305,15,81,1215,452,352,1.284090909
345,453,798,498,179,319,399,55,21945,500,99,5.050505051
395,16,411,431,331,100,500,188,94000,268,350,0.765714286
299,207,506,370,53,317,62,474,29388,51,455,0.112087912
323,254,577,102,316,-214,354,104,36816,496,276,1.797101449
60,322,382,262,244,18,66,318,20988,141,481,0.293139293
174,259,433,88,153,-65,73,243,17739,340,302,1.125827815
477,395,872,431,425,6,181,289,52309,292,75,3.893333333
116,400,516,487,110,377,178,496,88288,382,403,0.947890819
153,467,620,289,107,182,112,436,48832,229,301,0.760797342
293,445,738,412,113,299,211,182,38402,264,39,6.769230769
334,383,717,378,250,128,464,357,165648,315,399,0.789473684
161,382,543,434,159,275,439,274,120286,217,68,3.191176471
118,65,183,279,279,0,405,91,36855,24,137,0.175182482
239,148,387,320,384,-64,158,24,3792,265,362,0.732044199
487,217,704,58,383,-325,153,397,60741,104,43,2.418604651
360,199,559,374,480,-106,45,102,4590,179,211,0.848341232
270,397,667,436,462,-26,199,18,3582,334,179,1.865921788
235,130,365,38,245,-207,299,465,139035,135,372,0.362903226
301,109,410,19,127,-108,113,76,8588,463,365,1.268493151
430,150,580,378,161,217,183,258,47214,397,248,1.600806452
457,361,818,286,235,51,75,295,22125,365,444,0.822072072
125,21,146,275,255,20,347,452,156844,55,448,0.122767857
268,449,717,281,80,201,101,471,47571,386,472,0.81779661
351,355,706,112,292,-180,28,325,9100,201,13,15.46153846
379,142,521,419,271,148,130,186,24180,179,116,1.543103448
153,133,286,332,487,-155,222,345,76590,329,448,0.734375
383,143,526,171,132,39,327,366,119682,322,152,2.118421053
434,43,477,277,364,-87,363,307,111441,420,213,1.971830986
338,174,512,339,40,299,385,392,150920,250,22,11.36363636
317,174,491,147,161,-14,85,287,24395,113,388,0.291237113
282,275,557,216,213,3,78,454,35412,170,48,3.541666667
36,351,387,416,465,-49,49,373,18277,357,208,1.716346154
313,153,466,93,292,-199,330,405,133650,239,482,0.495850622
262,370,632,498,62,436,317,151,47867,133,291,0.457044674
189,271,460,87,317,-230,148,184,27232,183,447,0.409395973
216,14,230,223,134,89,286,463,132418,478,309,1.546925566
294,257,551,30,269,-239,239,494,118066,449,472,0.951271186
12,473,485,250,130,120,497,121,60137,350,112,3.125
130,479,609,96,454,-358,374,128,47872,102,271,0.376383764
394,95,489,284,292,-8,145,97,14065,184,96,1.916666667
479,70,549,245,130,115,205,342,70110,395,246,1.605691057
67,36,103,346,329,17,21,229,4809,406,389,1.043701799
389,436,825,234,371,-137,478,280,133840,495,429,1.153846154
201,244,445,347,203,144,74,131,9694,270,64,4.21875
300,231,531,397,297,100,399,18,7182,155,22,7.045454545
482,135,617,269,486,-217,289,351,101439,56,317,0.176656151
25,265,290,444,234,210,431,369,159039,308,494,0.623481781
95,81,176,93,351,-258,379,52,19708,358,43,8.325581395
308,273,581,187,63,124,473,473,223729,215,198,1.085858586
164,171,335,85,381,-296,401,46,18446,193,485,0.397938144
223,389,612,99,26,73,75,295,22125,425,107,3.971962617
164,310,474,162,190,-28,431,228,98268,261,327,0.798165138
423,241,664,391,123,268,185,60,11100,303,486,0.62345679
313,318,631,490,97,393,103,79,8137,118,429,0.275058275
80,210,290,285,92,193,261,407,106227,183,437,0.418764302
410,124,534,237,223,14,94,152,14288,162,427,0.379391101
317,178,495,317,229,88,488,475,231800,277,102,2.715686275
46,450,496,233,333,-100,491,140,68740,114,72,1.583333333
325,221,546,440,317,123,459,417,191403,443,372,1.190860215
296,284,580,354,49,305,142,445,63190,441,392,1.125
216,280,496,301,117,184,235,171,40185,113,477,0.236897275
339,183,522,244,262,-18,105,383,40215,97,335,0.289552239
92,481,573,241,493,-252,173,454,78542,192,349,0.550143266
247,204,451,199,328,-129,300,232,69600,319,81,3.938271605
108,168,276,400,325,75,90,494,44460,120,39,3.076923077
57,328,385,83,228,-145,266,330,87780,462,17,27.17647059
50,108,158,221,276,-55,493,300,147900,43,211,0.203791469
234,291,525,333,391,-58,412,493,203116,478,354,1.350282486
373,72,445,224,393,-169,323,478,154394,305,87,3.505747126
343,161,504,136,407,-271,468,145,67860,410,331,1.238670695
251,69,320,387,322,65,170,302,51340,187,328,0.570121951
161,248,409,302,15,287,369,380,140220,98,322,0.304347826
334,407,741,95,143,-48,23,482,11086,50,254,0.196850394
180,438,618,437,23,414,161,45,7245,454,475,0.955789474
276,127,403,201,139,62,484,303,146652,11,78,0.141025641
249,227,476,94,105,-11,244,441,107604,198,248,0.798387097
440,134,574,133,58,75,112,143,16016,206,484,0.425619835
479,296,775,229,407,-178,174,391,68034,259,224,1.15625
85,349,434,242,80,162,50,169,8450,47,189,0.248677249
98,115,213,360,357,3,332,494,164008,132,27,4.888888889
346,369,715,472,286,186,423,297,125631,11,318,0.034591195
28,82,110,445,498,-53,270,123,33210,238,489,0.486707566
468,270,738,387,119,268,427,18,7686,158,216,0.731481481
33,145,178,149,195,-46,24,390,9360,211,363,0.581267218
24,26,50,335,176,159,328,136,44608,108,484,0.223140496
152,312,464,267,474,-207,318,261,82998,442,463,0.954643629
248,481,729,231,405,-174,413,16,6608,407,98,4.153061224
274,364,638,396,65,331,281,341,95821,244,201,1.213930348
63,72,135,102,119,-17,406,177,71862,212,184,1.152173913
472,258,730,178,349,-171,411,321,131931,169,87,1.942528736
385,12,397,79,352,-273,103,24,2472,499,232,2.150862069
257,349,606,403,128,275,480,427,204960,491,374,1.312834225
270,120,390,139,274,-135,135,394,53190,253,466,0.542918455
224,471,695,121,334,-213,83,292,24236,335,235,1.425531915
319,331,650,488,219,269,454,276,125304,68,173,0.393063584
428,69,497,197,229,-32,393,231,90783,406,279,1.455197133
291,39,330,171,293,-122,248,357,88536,111,392,0.283163265
10,169,179,355,452,-97,407,17,6919,121,460,0.263043478
28,411,439,105,495,-390,304,200,60800,54,290,0.186206897
222,206,428,213,393,-180,35,12,420,65,384,0.169270833
183,155,338,42,285,-243,159,431,68529,175,446,0.392376682
473,224,697,429,442,-13,52,212,11024,165,95,1.736842105
308,139,447,86,357,-271,331,54,17874,311,75,4.146666667
396,230,626,149,439,-290,139,324,45036,407,465,0.875268817
63,464,527,158,490,-332,456,238,108528,339,389,0.871465296
299,463,762,134,198,-64,244,355,86620,449,16,28.0625
228,151,379,384,195,189,76,150,11400,410,470,0.872340426
433,194,627,325,84,241,68,120,8160,324,18,18
122,463,585,286,60,226,464,424,196736,193,425,0.454117647
228,255,483,159,26,133,364,212,77168,282,244,1.155737705
375,361,736,437,342,95,489,404,197556,194,32,6.0625
403,204,607,489,85,404,500,226,113000,328,424,0.773584906
20,52,72,329,478,-149,40,197,7880,229,498,0.459839357
362,389,751,200,272,-72,241,185,44585,47,15,3.133333333
395,96,491,433,392,41,101,498,50298,415,482,0.860995851
338,177,515,390,270,120,95,246,23370,352,487,0.722792608
314,445,759,25,353,-328,22,175,3850,211,45,4.688888889
310,413,723,88,99,-11,361,35,12635,160,40,4
276,11,287,441,156,285,134,25,3350,452,277,1.631768953
434,20,454,61,144,-83,33,211,6963,92,461,0.199566161
397,473,870,23,67,-44,32,170,5440,89,177,0.502824859
32,247,279,342,405,-63,190,62,11780,155,374,0.414438503
54,355,409,45,312,-267,21,312,6552,24,452,0.053097345
146,407,553,14,446,-432,124,204,25296,250,19,13.15789474
377,343,720,76,358,-282,331,29,9599,219,137,1.598540146
341,432,773,380,433,-53,336,198,66528,86,236,0.36440678
103,312,415,398,107,291,347,421,146087,139,290,0.479310345
158,420,578,234,298,-64,195,391,76245,484,366,1.322404372
74,15,89,454,87,367,404,183,73932,327,171,1.912280702
188,474,662,233,269,-36,411,216,88776,423,204,2.073529412
328,274,602,52,285,-233,428,344,147232,56,194,0.288659794
291,192,483,18,186,-168,244,348,84912,308,219,1.406392694
135,157,292,433,187,246,179,391,69989,129,313,0.412140575
429,39,468,174,346,-172,33,246,8118,282,309,0.912621359
194,109,303,364,180,184,383,47,18001,410,133,3.082706767
201,310,511,198,428,-230,349,339,118311,238,401,0.593516209
285,486,771,216,498,-282,272,394,107168,214,190,1.126315789
404,231,635,415,233,182,123,214,26322,408,120,3.4
467,453,920,203,374,-171,77,97,7469,111,349,0.318051576
317,200,517,433,382,51,315,114,35910,399,188,2.122340426
331,349,680,211,297,-86,429,113,48477,152,414,0.367149758
136,321,457,399,477,-78,439,376,165064,227,325,0.698461538
287,310,597,212,379,-167,370,226,83620,370,169,2.189349112
325,80,405,278,466,-188,233,155,36115,383,270,1.418518519
33,16,49,306,68,238,477,112,53424,39,66,0.590909091
248,261,509,117,486,-369,391,316,123556,57,168,0.339285714
237,316,553,312,79,233,425,422,179350,299,13,23
423,445,868,474,336,138,458,261,119538,419,95,4.410526316
422,499,921,229,401,-172,24,421,10104,479,140,3.421428571
294,194,488,416,455,-39,407,104,42328,241,189,1.275132275
31,67,98,247,378,-131,206,26,5356,488,347,1.406340058
137,32,169,267,332,-65,148,386,57128,304,362,0.839779006
350,461,811,44,415,-371,200,405,81000,162,299,0.54180602
230,64,294,294,49,245,228,166,37848,178,42,4.238095238
263,164,427,169,68,101,330,207,68310,399,77,5.181818182
237,50,287,221,234,-13,471,127,59817,180,73,2.465753425
421,267,688,428,17,411,11,323,3553,383,474,0.808016878
112,141,253,406,25,381,235,303,71205,41,140,0.292857143
489,54,543,480,22,458,281,342,96102,87,296,0.293918919
38,79,117,330,255,75,28,337,9436,427,115,3.713043478
485,169,654,219,197,22,107,462,49434,421,410,1.026829268
205,344,549,261,466,-205,371,403,149513,417,21,19.85714286
134,11,145,207,400,-193,193,19,3667,451,225,2.004444444
411,123,534,194,178,16,197,259,51023,439,319,1.376175549
480,48,528,385,350,35,262,468,122616,423,338,1.25147929
409,86,495,438,267,171,218,388,84584,317,135,2.348148148
313,14,327,62,84,-22,161,122,19642,239,98,2.43877551
209,302,511,333,195,138,12,110,1320,351,368,0.953804348
427,100,527,195,118,77,315,142,44730,88,474,0.185654008
55,132,187,123,293,-170,495,319,157905,153,63,2.428571429
125,331,456,393,328,65,76,434,32984,219,344,0.636627907
382,161,543,215,160,55,187,494,92378,142,57,2.49122807
185,471,656,230,312,-82,166,176,29216,400,493,0.811359026
177,400,577,38,227,-189,94,479,45026,309,165,1.872727273
119,317,436,490,44,446,165,376,62040,366,37,9.891891892
365,351,716,390,391,-1,265,215,56975,76,284,0.267605634
181,134,315,216,248,-32,152,115,17480,204,239,0.853556485
385,375,760,182,49,133,116,101,11716,163,155,1.051612903
50,109,159,486,385,101,343,88,30184,96,354,0.271186441
486,97,583,184,236,-52,244,246,60024,281,294,0.955782313
162,92,254,461,490,-29,91,424,38584,319,245,1.302040816
351,474,825,476,76,400,488,311,151768,177,232,0.762931034
311,357,668,233,52,181,477,483,230391,448,373,1.201072386
195,317,512,302,77,225,101,133,13433,351,372,0.943548387
339,120,459,151,79,72,234,305,71370,52,333,0.156156156
246,301,547,242,448,-206,352,262,92224,104,499,0.208416834
114,129,243,190,100,90,213,263,56019,151,264,0.571969697
481,12,493,210,433,-223,472,133,62776,145,119,1.218487395
244,21,265,77,42,35,127,38,4826,115,295,0.389830508
424,47,471,20,319,-299,154,404,62216,429,44,9.75
274,17,291,477,348,129,232,215,49880,403,85,4.741176471
283,311,594,118,463,-345,392,305,119560,244,300,0.813333333
253,221,474,479,378,101,240,285,68400,262,310,0.84516129
158,128,286,102,350,-248,187,102,19074,244,267,0.913857678
290,154,444,262,434,-172,78,442,34476,201,82,2.451219512
421,306,727,111,368,-257,402,207,83214,134,303,0.442244224
82,462,544,408,366,42,227,116,26332,486,83,5.855421687
36,82,118,290,401,-111,437,146,63802,339,18,18.83333333
216,55,271,400,12,388,167,397,66299,473,423,1.11820331
244,473,717,271,296,-25,49,446,21854,279,262,1.064885496
387,80,467,461,58,403,288,111,31968,107,335,0.319402985
430,293,723,453,56,397,54,227,12258,36,463,0.07775378
142,134,276,202,331,-129,82,336,27552,303,469,0.646055437
398,242,640,492,457,35,352,343,120736,108,133,0.812030075
166,298,464,122,36,86,134,295,39530,173,417,0.414868106
421,166,587,230,207,23,474,481,227994,115,208,0.552884615
397,366,763,280,262,18,154,79,12166,56,86,0.651162791
298,382,680,428,385,43,496,317,157232,298,199,1.497487437
410,403,813,419,145,274,385,240,92400,267,126,2.119047619
91,228,319,240,389,-149,193,194,37442,110,308,0.357142857
36,146,182,243,412,-169,414,363,150282,235,370,0.635135135
433,156,589,205,302,-97,471,341,160611,228,339,0.672566372
40,140,180,41,202,-161,309,165,50985,408,461,0.885032538
484,387,871,471,377,94,190,247,46930,71,158,0.449367089
440,252,692,431,358,73,312,264,82368,148,377,0.392572944
17,334,351,366,447,-81,81,341,27621,206,225,0.915555556
485,129,614,35,27,8,442,195,86190,290,315,0.920634921
283,325,608,121,120,1,30,35,1050,341,41,8.317073171
265,443,708,119,35,84,351,113,39663,234,458,0.510917031
498,462,960,379,37,342,484,412,199408,447,436,1.025229358
143,494,637,238,256,-18,97,103,9991,490,466,1.051502146
408,349,757,77,215,-138,338,324,109512,424,259,1.637065637
30,81,111,119,177,-58,447,24,10728,249,94,2.64893617
243,437,680,431,16,415,496,112,55552,264,411,0.642335766
27,488,515,449,207,242,460,61,28060,58,216,0.268518519
33,315,348,177,461,-284,87,67,5829,226,389,0.580976864
495,68,563,449,200,249,434,300,130200,272,311,0.874598071
65,298,363,303,112,191,320,296,94720,453,35,12.94285714
438,52,490,386,69,317,129,371,47859,55,263,0.209125475
218,292,510,433,390,43,54,234,12636,457,88,5.193181818
174,90,264,91,91,0,222,481,106782,426,299,1.424749164
410,481,891,213,295,-82,267,486,129762,29,133,0.218045113
197,479,676,456,125,331,440,103,45320,486,412,1.17961165
11,188,199,57,350,-293,262,22,5764,221,293,0.754266212
491,266,757,29,273,-244,428,455,194740,458,250,1.832
277,477,754,475,455,20,153,401,61353,458,151,3.033112583
330,157,487,117,345,-228,215,451,96965,370,133,2.781954887
134,121,255,60,140,-80,240,403,96720,368,349,1.054441261
268,491,759,484,403,81,45,357,16065,400,118,3.389830508
426,444,870,179,310,-131,377,71,26767,434,491,0.883910387
303,66,369,320,192,128,461,452,208372,61,324,0.188271605
483,18,501,437,328,109,250,52,13000,280,289,0.968858131
94,456,550,129,348,-219,357,202,72114,462,103,4.485436893
129,438,567,207,422,-215,113,142,16046,237,17,13.94117647
314,486,800,427,304,123,146,48,7008,14,22,0.636363636
337,215,552,315,317,-2,239,451,107789,63,357,0.176470588
303,106,409,41,367,-326,391,191,74681,444,307,1.446254072
424,242,666,205,55,150,308,53,16324,347,270,1.285185185
148,157,305,354,307,47,291,454,132114,388,490,0.791836735
234,301,535,51,336,-285,329,230,75670,303,202,1.5
482,32,514,122,299,-177,467,175,81725,131,128,1.0234375
102,139,241,436,274,162,118,144,16992,145,12,12.08333333
408,59,467,106,417,-311,290,167,48430,313,72,4.347222222
471,461,932,94,380,-286,290,83,24070,88,31,2.838709677
322,183,505,352,447,-95,131,150,19650,483,271,1.782287823
306,155,461,117,81,36,98,258,25284,85,492,0.172764228
175,293,468,75,200,-125,38,110,4180,172,185,0.92972973
267,455,722,276,198,78,320,82,26240,143,370,0.386486486
320,367,687,292,148,144,478,289,138142,424,352,1.204545455
467,255,722,236,377,-141,289,371,107219,306,135,2.266666667
131,67,198,448,180,268,160,193,30880,382,493,0.77484787
436,107,543,494,300,194,11,308,3388,403,152,2.651315789
149,56,205,440,326,114,363,159,57717,199,167,1.191616766
253,11,264,98,263,-165,14,69,966,333,396,0.840909091
110,349,459,153,145,8,316,471,148836,88,78,1.128205128
450,493,943,174,237,-63,414,412,170568,346,253,1.367588933
430,232,662,374,108,266,481,12,5772,164,31,5.290322581
450,280,730,86,342,-256,357,157,56049,361,193,1.870466321
49,77,126,421,218,203,448,176,78848,432,303,1.425742574
36,125,161,265,227,38,231,222,51282,477,406,1.174876847
149,218,367,299,241,58,127,75,9525,30,485,0.06185567
23,470,493,264,161,103,250,37,9250,26,387,0.067183463
357,122,479,114,397,-283,172,409,70348,189,142,1.330985915
263,366,629,31,349,-318,294,205,60270,209,118,1.771186441
331,497,828,200,407,-207,456,196,89376,305,67,4.552238806
242,149,391,421,153,268,313,64,20032,282,284,0.992957746
370,166,536,167,169,-2,89,145,12905,428,12,35.66666667
144,133,277,16,269,-253,153,216,33048,128,408,0.31372549
258,120,378,201,189,12,30,492,14760,179,96,1.864583333
332,384,716,366,239,127,303,56,16968,376,361,1.041551247
121,133,254,318,364,-46,350,158,55300,139,24,5.791666667
115,162,277,416,482,-66,80,105,8400,445,110,4.045454545
258,321,579,355,188,167,390,349,136110,322,109,2.95412844
369,488,857,29,309,-280,181,107,19367,205,249,0.823293173
297,424,721,28,108,-80,355,106,37630,478,297,1.609427609
42,455,497,312,208,104,445,199,88555,441,467,0.944325482
39,486,525,347,486,-139,432,167,72144,259,227,1.140969163
41,31,72,306,424,-118,399,127,50673,120,12,10
25,118,143,421,10,411,132,433,57156,317,324,0.978395062
157,116,273,15,333,-318,32,434,13888,309,311,0.993569132
389,267,656,284,102,182,16,20,320,246,232,1.060344828
319,385,704,388,366,22,166,136,22576,357,30,11.9
232,148,380,369,481,-112,416,301,125216,145,71,2.042253521
61,426,487,221,439,-218,221,24,5304,102,270,0.377777778
499,251,750,145,441,-296,32,65,2080,422,432,0.976851852
291,455,746,434,57,377,486,46,22356,181,218,0.830275229
141,174,315,428,376,52,31,286,8866,145,222,0.653153153
29,220,249,297,427,-130,136,237,32232,296,269,1.100371747
377,37,414,159,70,89,188,414,77832,76,402,0.189054726
150,435,585,174,184,-10,191,493,94163,383,113,3.389380531
91,35,126,29,147,-118,327,217,70959,278,82,3.390243902
324,214,538,181,284,-103,361,418,150898,56,189,0.296296296
93,426,519,114,415,-301,321,280,89880,378,486,0.777777778
101,28,129,28,409,-381,84,161,13524,461,152,3.032894737
453,464,917,237,107,130,445,431,191795,466,111,4.198198198
488,406,894,415,464,-49,17,143,2431,34,291,0.116838488
106,370,476,290,392,-102,269,361,97109,473,111,4.261261261
358,324,682,286,204,82,62,368,22816,123,153,0.803921569
219,488,707,276,341,-65,475,440,209000,101,186,0.543010753
236,324,560,86,468,-382,315,365,114975,403,152,2.651315789
27,68,95,17,74,-57,270,143,38610,123,208,0.591346154
376,492,868,50,185,-135,74,253,18722,144,250,0.576
91,276,367,127,364,-237,33,453,14949,268,481,0.557172557
316,79,395,362,433,-71,164,166,27224,50,461,0.10845987
416,464,880,417,429,-12,165,214,35310,71,46,1.543478261
415,122,537,58,261,-203,11,215,2365,23,376,0.061170213
439,445,884,191,486,-295,439,19,8341,357,451,0.791574279
404,67,471,449,402,47,35,213,7455,464,465,0.997849462
102,105,207,312,275,37,156,109,17004,432,237,1.82278481
46,320,366,282,172,110,140,236,33040,353,318,1.110062893
251,200,451,126,115,11,327,471,154017,312,330,0.945454545
31,396,427,262,477,-215,198,353,69894,172,322,0.534161491
478,53,531,137,370,-233,52,217,11284,152,277,0.548736462
251,173,424,247,297,-50,367,108,39636,225,488,0.461065574
171,441,612,261,368,-107,197,392,77224,481,29,16.5862069
349,399,748,295,16,279,102,238,24276,120,103,1.165048544
374,403,777,284,399,-115,275,244,67100,419,352,1.190340909
213,286,499,116,404,-288,214,14,2996,487,252,1.932539683
178,336,514,120,47,73,471,346,162966,469,334,1.404191617
329,86,415,267,77,190,330,281,92730,184,378,0.486772487
34,129,163,267,355,-88,12,500,6000,417,120,3.475
122,425,547,117,388,-271,376,184,69184,201,402,0.5
205,315,520,159,119,40,385,382,147070,271,237,1.143459916
408,232,640,92,179,-87,54,136,7344,52,450,0.115555556
497,343,840,105,68,37,345,417,143865,269,25,10.76
112,354,466,333,428,-95,263,231,60753,162,145,1.117241379
278,257,535,169,250,-81,412,200,82400,373,149,2.503355705
110,120,230,167,184,-17,477,385,183645,98,475,0.206315789
390,362,752,193,231,-38,370,349,129130,34,93,0.365591398
241,426,667,230,14,216,255,194,49470,18,177,0.101694915
481,314,795,10,249,-239,445,228,101460,237,298,0.795302013
397,493,890,100,286,-186,300,483,144900,20,383,0.052219321
174,222,396,333,402,-69,278,166,46148,312,177,1.762711864
214,29,243,230,102,128,431,275,118525,305,396,0.77020202
304,221,525,313,453,-140,171,271,46341,184,442,0.416289593
153,333,486,124,66,58,438,87,38106,376,299,1.257525084
92,13,105,56,418,-362,225,87,19575,243,100,2.43
120,263,383,230,39,191,421,173,72833,449,447,1.004474273
17,108,125,241,320,-79,39,137,5343,236,364,0.648351648
486,468,954,243,42,201,195,83,16185,207,29,7.137931034
356,171,527,223,300,-77,430,470,202100,471,342,1.377192982
245,10,255,403,325,78,147,211,31017,69,84,0.821428571
345,439,784,341,376,-35,244,444,108336,212,44,4.818181818
108,471,579,325,387,-62,353,259,91427,124,62,2
362,404,766,454,455,-1,17,128,2176,164,50,3.28
481,167,648,498,331,167,134,168,22512,257,278,0.924460432
128,371,499,267,236,31,413,204,84252,28,450,0.062222222
393,430,823,444,488,-44,392,401,157192,252,326,0.773006135
213,422,635,371,302,69,275,205,56375,72,220,0.327272727
96,485,581,419,486,-67,370,164,60680,157,54,2.907407407
246,222,468,243,203,40,158,15,2370,155,447,0.346756152
371,49,420,260,80,180,378,82,30996,51,211,0.241706161
19,229,248,95,433,-338,379,382,144778,207,376,0.550531915
418,45,463,220,227,-7,494,270,133380,285,327,0.871559633
108,205,313,401,305,96,262,276,72312,332,250,1.328
337,32,369,91,238,-147,334,418,139612,303,302,1.003311258
349,42,391,276,420,-144,116,232,26912,22,260,0.084615385
43,370,413,220,189,31,182,85,15470,96,485,0.197938144
426,368,794,174,100,74,200,415,83000,198,377,0.525198939
20,458,478,496,163,333,435,36,15660,18,287,0.06271777
427,341,768,328,193,135,361,40,14440,113,286,0.395104895
341,273,614,218,82,136,240,476,114240,99,77,1.285714286
333,152,485,310,148,162,38,425,16150,485,282,1.719858156
463,201,664,455,357,98,365,435,158775,395,28,14.10714286
163,170,333,209,110,99,85,397,33745,170,258,0.658914729
262,314,576,60,265,-205,124,469,58156,377,496,0.760080645
416,395,811,405,73,332,266,303,80598,477,103,4.631067961
113,394,507,13,315,-302,210,468,98280,34,74,0.459459459
496,312,808,173,459,-286,29,176,5104,16,257,0.062256809
230,414,644,292,183,109,254,57,14478,443,185,2.394594595
103,49,152,285,441,-156,441,322,142002,397,474,0.837552743
470,55,525,46,184,-138,442,104,45968,243,251,0.96812749
212,62,274,190,352,-162,107,66,7062,166,483,0.3436853
225,255,480,474,73,401,415,316,131140,497,200,2.485
76,76,152,222,310,-88,76,374,28424,264,161,1.639751553
29,389,418,269,234,35,216,419,90504,70,281,0.24911032
385,157,542,374,235,139,47,189,8883,492,405,1.214814815
343,344,687,78,206,-128,219,15,3285,150,203,0.738916256
397,461,858,137,376,-239,221,210,46410,127,390,0.325641026
283,345,628,497,287,210,394,400,157600,276,233,1.184549356
321,301,622,478,41,437,470,264,124080,394,348,1.132183908
488,334,822,462,426,36,177,18,3186,475,287,1.655052265
159,159,318,490,84,406,398,123,48954,340,481,0.706860707
205,422,627,163,79,84,19,291,5529,280,66,4.242424242
317,48,365,357,119,238,26,287,7462,82,373,0.219839142
477,218,695,277,77,200,314,263,82582,405,190,2.131578947
459,460,919,206,74,132,46,353,16238,266,430,0.618604651
322,227,549,213,28,185,361,285,102885,304,247,1.230769231
245,474,719,35,442,-407,23,83,1909,234,283,0.826855124
297,139,436,85,143,-58,451,366,165066,291,481,0.604989605
149,469,618,248,491,-243,160,383,61280,467,252,1.853174603
324,441,765,312,227,85,486,328,159408,17,322,0.052795031
90,124,214,383,154,229,230,202,46460,201,99,2.03030303
143,36,179,108,15,93,68,312,21216,16,260,0.061538462
199,310,509,311,467,-156,19,83,1577,323,246,1.31300813
471,347,818,386,453,-67,74,357,26418,38,159,0.238993711
169,163,332,83,435,-352,249,260,64740,299,70,4.271428571
245,286,531,353,324,29,211,433,91363,420,148,2.837837838
498,323,821,37,308,-271,258,358,92364,443,12,36.91666667
332,52,384,85,461,-376,48,116,5568,428,253,1.691699605
243,340,583,263,450,-187,362,28,10136,334,296,1.128378378
270,311,581,337,122,215,340,377,128180,232,336,0.69047619
121,110,231,414,325,89,356,290,103240,102,360,0.283333333
166,124,290,197,460,-263,438,107,46866,447,190,2.352631579
68,495,563,116,322,-206,177,499,88323,377,320,1.178125
65,405,470,53,25,28,17,74,1258,314,213,1.474178404
74,429,503,21,312,-291,436,71,30956,127,282,0.45035461
190,225,415,437,78,359,153,23,3519,102,35,2.914285714
110,182,292,241,111,130,78,147,11466,482,170,2.835294118
494,458,952,412,369,43,13,69,897,64,204,0.31372549
116,313,429,279,194,85,130,334,43420,164,276,0.594202899
476,296,772,282,114,168,337,113,38081,250,150,1.666666667
446,404,850,191,263,-72,295,62,18290,139,447,0.310961969
457,450,907,293,155,138,181,31,5611,377,279,1.35125448
95,46,141,304,420,-116,327,399,130473,458,486,0.942386831
272,167,439,235,383,-148,85,258,21930,185,54,3.425925926
141,300,441,46,225,-179,472,197,92984,204,162,1.259259259
486,473,959,308,466,-158,406,436,177016,94,186,0.505376344
270,62,332,166,484,-318,155,154,23870,324,201,1.611940299
283,490,773,55,300,-245,202,407,82214,441,60,7.35
464,196,660,413,466,-53,92,309,28428,445,24,18.54166667
221,27,248,458,272,186,311,486,151146,156,271,0.575645756
324,249,573,62,464,-402,463,48,22224,421,336,1.25297619
424,264,688,224,498,-274,343,339,116277,406,333,1.219219219
309,418,727,298,484,-186,426,491,209166,47,270,0.174074074
233,92,325,300,430,-130,197,394,77618,288,500,0.576
267,372,639,376,497,-121,123,480,59040,497,252,1.972222222
396,200,596,373,102,271,103,486,50058,425,21,20.23809524
50,491,541,268,213,55,442,259,114478,283,336,0.842261905
340,261,601,493,423,70,333,337,112221,85,356,0.238764045
407,16,423,194,185,9,74,316,23384,338,35,9.657142857
463,73,536,247,295,-48,459,170,78030,450,321,1.401869159
494,328,822,63,171,-108,132,53,6996,119,105,1.133333333
277,362,639,195,455,-260,483,190,91770,158,406,0.389162562
365,179,544,364,207,157,63,106,6678,234,415,0.563855422
43,78,121,496,197,299,479,139,66581,211,59,3.576271186
21,355,376,285,210,75,440,236,103840,401,187,2.144385027
182,370,552,333,195,138,436,217,94612,431,12,35.91666667
132,38,170,191,356,-165,340,493,167620,339,71,4.774647887
221,383,604,485,23,462,478,239,114242,132,498,0.265060241
209,188,397,276,121,155,452,476,215152,179,212,0.844339623
220,101,321,137,405,-268,373,239,89147,430,344,1.25
139,222,361,210,201,9,316,241,76156,49,274,0.178832117
218,360,578,55,17,38,138,404,55752,279,351,0.794871795
240,161,401,74,145,-71,205,14,2870,435,289,1.505190311
12,245,257,487,58,429,146,328,47888,222,167,1.329341317
139,425,564,210,318,-108,491,426,209166,448,340,1.317647059
196,76,272,326,195,131,160,278,44480,196,484,0.404958678
374,209,583,121,280,-159,462,53,24486,402,88,4.568181818
59,397,456,96,390,-294,344,500,172000,325,248,1.310483871
172,493,665,166,426,-260,73,483,35259,429,161,2.664596273
428,424,852,75,422,-347,374,73,27302,129,77,1.675324675
398,342,740,210,481,-271,358,208,74464,422,436,0.967889908
281,309,590,290,271,19,426,51,21726,402,156,2.576923077
208,232,440,200,492,-292,353,89,31417,187,173,1.080924855
46,145,191,67,139,-72,451,44,19844,80,129,0.620155039
164,275,439,321,416,-95,461,425,195925,171,240,0.7125
439,454,893,346,416,-70,381,493,187833,281,495,0.567676768
357,19,376,366,118,248,183,475,86925,204,255,0.8
219,464,683,20,423,-403,44,482,21208,233,213,1.093896714
485,109,594,394,473,-79,88,302,26576,462,119,3.882352941
454,425,879,232,119,113,124,199,24676,245,102,2.401960784
242,134,376,401,22,379,229,403,92287,376,297,1.265993266
490,32,522,232,486,-254,287,355,101885,192,182,1.054945055
470,257,727,304,133,171,12,94,1128,327,55,5.945454545
39,97,136,394,129,265,125,391,48875,468,466,1.004291845
247,159,406,246,71,175,107,483,51681,457,369,1.238482385
229,367,596,232,390,-158,43,301,12943,112,21,5.333333333
378,295,673,47,249,-202,97,395,38315,77,62,1.241935484
484,448,932,253,395,-142,249,415,103335,313,422,0.741706161
286,166,452,265,109,156,35,38,1330,162,337,0.480712166
436,128,564,298,158,140,200,10,2000,227,236,0.961864407
38,38,76,104,71,33,115,108,12420,112,491,0.228105906
120,454,574,332,362,-30,107,398,42586,163,162,1.00617284
428,497,925,237,252,-15,77,249,19173,283,33,8.575757576
419,75,494,416,22,394,393,80,31440,339,201,1.686567164
57,62,119,427,476,-49,113,395,44635,460,78,5.897435897
171,402,573,40,419,-379,283,488,138104,291,308,0.944805195
86,232,318,253,288,-35,24,87,2088,436,419,1.040572792
123,116,239,242,481,-239,13,143,1859,404,166,2.43373494
221,159,380,40,214,-174,430,138,59340,484,413,1.171912833
42,157,199,151,312,-161,143,188,26884,56,270,0.207407407
145,92,237,475,95,380,306,25,7650,431,396,1.088383838
60,52,112,336,327,9,36,202,7272,454,353,1.28611898
15,195,210,24,402,-378,256,119,30464,79,393,0.201017812
13,380,393,271,383,-112,161,361,58121,269,453,0.593818985
186,241,427,147,254,-107,339,170,57630,389,144,2.701388889
153,111,264,317,29,288,168,227,38136,440,59,7.457627119
327,446,773,174,32,142,498,28,13944,167,169,0.98816568
65,357,422,218,140,78,496,69,34224,412,89,4.629213483
442,498,940,81,57,24,279,225,62775,72,101,0.712871287
269,451,720,234,149,85,482,176,84832,488,458,1.065502183
372,284,656,286,479,-193,405,21,8505,41,178,0.230337079
381,78,459,353,227,126,305,267,81435,337,281,1.199288256
466,422,888,380,202,178,71,159,11289,391,412,0.949029126
441,292,733,206,447,-241,481,116,55796,242,255,0.949019608
258,54,312,337,301,36,322,414,133308,472,391,1.207161125
266,90,356,428,373,55,133,294,39102,442,61,7.245901639
164,451,615,246,190,56,57,333,18981,135,377,0.358090186
211,130,341,375,203,172,218,90,19620,62,214,0.289719626
110,42,152,268,21,247,127,399,50673,446,203,2.197044335
500,56,556,352,62,290,115,95,10925,386,14,27.57142857
227,471,698,99,327,-228,251,310,77810,215,232,0.926724138
316,99,415,152,263,-111,190,341,64790,218,416,0.524038462
122,459,581,439,191,248,414,205,84870,89,154,0.577922078
212,246,458,245,219,26,211,44,9284,144,381,0.377952756
388,388,776,198,499,-301,248,324,80352,355,472,0.752118644
320,448,768,388,54,334,199,480,95520,257,143,1.797202797
122,163,285,336,143,193,424,229,97096,263,55,4.781818182
321,382,703,358,295,63,273,156,42588,420,13,32.30769231
113,392,505,350,126,224,254,132,33528,470,445,1.056179775
136,124,260,324,183,141,445,453,201585,422,200,2.11
201,212,413,394,248,146,438,213,93294,297,346,0.858381503
261,191,452,368,331,37,229,421,96409,136,347,0.391930836
260,245,505,131,39,92,248,482,119536,375,342,1.096491228
476,34,510,362,301,61,492,473,232716,116,23,5.043478261
178,306,484,360,139,221,184,494,90896,449,499,0.899799599
195,286,481,71,173,-102,433,390,168870,222,481,0.461538462
434,97,531,487,280,207,212,137,29044,257,387,0.664082687
146,312,458,43,459,-416,16,196,3136,365,58,6.293103448
308,447,755,367,304,63,344,282,97008,468,322,1.453416149
102,254,356,280,491,-211,279,63,17577,140,416,0.336538462
23,454,477,376,488,-112,231,342,79002,487,237,2.054852321
225,443,668,170,240,-70,352,101,35552,342,452,0.756637168
141,471,612,483,428,55,224,474,106176,288,239,1.205020921
286,59,345,106,342,-236,256,174,44544,322,258,1.248062016
309,359,668,185,192,-7,350,352,123200,347,196,1.770408163
204,14,218,101,244,-143,74,222,16428,25,171,0.14619883
225,325,550,128,235,-107,204,44,8976,495,198,2.5
138,33,171,460,168,292,132,244,32208,477,228,2.092105263
362,271,633,326,122,204,462,214,98868,204,399,0.511278195
155,269,424,337,35,302,305,212,64660,118,199,0.592964824
229,260,489,195,63,132,322,210,67620,79,34,2.323529412
17,183,200,231,109,122,296,158,46768,411,66,6.227272727
375,32,407,265,292,-27,407,192,78144,384,281,1.366548043
204,105,309,447,190,257,45,65,2925,358,238,1.504201681
220,212,432,403,392,11,359,190,68210,204,250,0.816
331,234,565,488,100,388,244,101,24644,260,348,0.747126437
132,472,604,131,312,-181,284,400,113600,417,13,32.07692308
262,285,547,25,345,-320,171,430,73530,250,217,1.152073733
86,271,357,229,401,-172,242,143,34606,377,150,2.513333333
226,481,707,307,449,-142,418,116,48488,80,194,0.412371134
342,487,829,64,229,-165,153,168,25704,476,43,11.06976744
351,263,614,50,393,-343,182,378,68796,403,280,1.439285714
185,494,679,443,220,223,22,377,8294,83,419,0.198090692
280,328,608,228,460,-232,377,32,12064,414,347,1.193083573
179,195,374,42,45,-3,369,122,45018,274,383,0.7154047
455,395,850,331,222,109,85,161,13685,375,20,18.75
18,238,256,476,246,230,367,52,19084,342,446,0.766816143
298,144,442,472,136,336,86,386,33196,150,464,0.323275862
170,251,421,246,314,-68,55,358,19690,41,79,0.518987342
228,382,610,202,466,-264,385,454,174790,388,154,2.519480519
462,292,754,489,281,208,22,31,682,328,141,2.326241135
322,392,714,262,456,-194,370,191,70670,128,48,2.666666667
279,277,556,82,407,-325,130,300,39000,479,168,2.851190476
382,443,825,69,416,-347,271,386,104606,169,220,0.768181818
16,68,84,148,141,7,376,142,53392,265,267,0.992509363
497,138,635,375,55,320,372,190,70680,474,484,0.979338843
446,164,610,260,393,-133,114,66,7524,39,115,0.339130435
201,317,518,70,27,43,461,263,121243,388,217,1.788018433
384,485,869,309,462,-153,252,349,87948,343,126,2.722222222
149,456,605,378,412,-34,467,47,21949,115,260,0.442307692
67,281,348,491,434,57,378,123,46494,187,193,0.968911917
148,232,380,129,465,-336,222,205,45510,84,232,0.362068966
313,85,398,406,134,272,401,26,10426,298,430,0.693023256
264,263,527,164,322,-158,307,132,40524,102,188,0.542553191
458,345,803,159,219,-60,324,334,108216,194,378,0.513227513
190,166,356,385,432,-47,253,17,4301,236,350,0.674285714
218,432,650,327,242,85,332,368,122176,499,241,2.070539419
27,197,224,173,408,-235,375,422,158250,133,328,0.405487805
271,22,293,373,470,-97,72,379,27288,251,211,1.18957346
488,127,615,115,169,-54,193,295,56935,182,323,0.563467492
214,158,372,264,72,192,355,427,151585,38,291,0.130584192
381,424,805,488,184,304,151,404,61004,129,118,1.093220339
157,51,208,483,11,472,303,127,38481,449,12,37.41666667
151,40,191,388,150,238,33,88,2904,192,110,1.745454545
10,38,48,343,469,-126,98,484,47432,310,223,1.390134529
363,430,793,381,387,-6,160,397,63520,403,116,3.474137931
225,148,373,453,211,242,365,327,119355,434,39,11.12820513
290,315,605,446,303,143,148,156,23088,308,391,0.787723785
69,366,435,82,415,-333,500,24,12000,139,169,0.822485207
471,497,968,393,94,299,260,172,44720,231,15,15.4
487,40,527,313,380,-67,122,37,4514,201,311,0.646302251
263,417,680,196,371,-175,218,202,44036,438,224,1.955357143
389,396,785,266,76,190,71,85,6035,340,450,0.755555556
337,34,371,225,125,100,59,435,25665,12,176,0.068181818
436,97,533,449,478,-29,75,146,10950,168,231,0.727272727
296,284,580,39,59,-20,382,336,128352,327,76,4.302631579
393,100,493,28,24,4,152,49,7448,70,28,2.5
436,375,811,481,120,361,76,284,21584,155,349,0.444126074
393,29,422,356,117,239,265,109,28885,337,156,2.16025641
40,304,344,424,490,-66,201,177,35577,398,89,4.471910112
122,32,154,155,421,-266,500,81,40500,293,233,1.25751073
86,164,250,403,159,244,35,135,4725,343,494,0.694331984
338,22,360,30,285,-255,80,236,18880,246,386,0.637305699
257,349,606,135,363,-228,236,342,80712,357,13,27.46153846
111,68,179,324,448,-124,434,366,158844,368,82,4.487804878
105,478,583,68,251,-183,492,48,23616,56,264,0.212121212
479,347,826,451,129,322,208,65,13520,370,456,0.811403509
149,112,261,285,261,24,493,493,243049,345,464,0.743534483
179,54,233,324,359,-35,410,192,78720,481,18,26.72222222
109,29,138,263,483,-220,499,343,171157,72,41,1.756097561
273,244,517,310,491,-181,143,268,38324,322,354,0.90960452
331,478,809,278,135,143,172,380,65360,474,419,1.131264916
208,159,367,416,315,101,272,232,63104,106,135,0.785185185
333,327,660,365,132,233,194,134,25996,35,181,0.193370166
337,79,416,37,42,-5,75,326,24450,185,497,0.3722334
57,204,261,441,374,67,416,368,153088,222,225,0.986666667
298,197,495,339,260,79,106,341,36146,416,246,1.691056911
455,301,756,495,190,305,217,437,94829,78,316,0.246835443
316,340,656,103,252,-149,77,82,6314,174,306,0.568627451
362,336,698,390,446,-56,301,333,100233,351,300,1.17
456,119,575,385,330,55,446,79,35234,291,93,3.129032258
44,113,157,148,416,-268,376,396,148896,367,320,1.146875
420,265,685,247,203,44,79,270,21330,393,275,1.429090909
31,418,449,116,211,-95,282,193,54426,398,473,0.841437632
268,282,550,99,485,-386,373,181,67513,89,355,0.250704225
102,218,320,99,334,-235,393,244,95892,357,153,2.333333333
182,71,253,251,246,5,24,177,4248,224,276,0.811594203
25,332,357,403,427,-24,346,120,41520,203,293,0.692832765
491,99,590,466,424,42,46,209,9614,107,73,1.465753425
499,370,869,336,267,69,318,92,29256,260,402,0.646766169
366,218,584,40,220,-180,79,151,11929,279,10,27.9
253,257,510,186,200,-14,464,193,89552,136,248,0.548387097
365,121,486,201,309,-108,16,207,3312,217,383,0.566579634
193,127,320,463,363,100,378,363,137214,115,464,0.247844828
21,175,196,60,182,-122,88,435,38280,318,420,0.757142857
312,154,466,114,285,-171,247,407,100529,269,200,1.345
66,364,430,468,233,235,427,107,45689,394,53,7.433962264
250,456,706,278,186,92,54,341,18414,106,33,3.212121212
485,10,495,334,437,-103,315,382,120330,356,318,1.119496855
120,83,203,459,147,312,57,309,17613,355,21,16.9047619
290,146,436,11,293,-282,430,374,160820,371,456,0.813596491
72,236,308,299,491,-192,121,456,55176,483,375,1.288
181,374,555,445,495,-50,219,81,17739,79,269,0.293680297
125,286,411,282,16,266,224,468,104832,259,411,0.630170316
437,232,669,276,471,-195,155,210,32550,214,447,0.478747204
333,142,475,351,411,-60,500,41,20500,253,438,0.577625571
120,339,459,56,341,-285,161,126,20286,39,277,0.140794224
199,164,363,459,61,398,49,313,15337,496,61,8.131147541
362,307,669,96,121,-25,187,184,34408,475,219,2.168949772
139,246,385,245,33,212,95,130,12350,99,277,0.357400722
386,368,754,169,315,-146,247,240,59280,17,41,0.414634146
476,344,820,305,108,197,77,460,35420,397,373,1.064343164
401,328,729,28,376,-348,392,40,15680,227,278,0.816546763
312,386,698,276,372,-96,76,65,4940,91,363,0.250688705
263,25,288,114,458,-344,204,448,91392,275,434,0.633640553
433,427,860,323,30,293,361,345,124545,146,227,0.643171806
300,121,421,24,69,-45,261,75,19575,213,178,1.196629213
288,455,743,255,391,-136,479,345,165255,198,363,0.545454545
333,455,788,362,249,113,392,280,109760,134,10,13.4
417,48,465,131,417,-286,339,189,64071,302,403,0.749379653
199,413,612,288,483,-195,298,498,148404,306,10,30.6
173,133,306,232,358,-126,370,53,19610,273,418,0.653110048
143,428,571,189,229,-40,115,367,42205,27,445,0.060674157
363,54,417,84,443,-359,351,475,166725,134,182,0.736263736
62,122,184,220,439,-219,38,98,3724,485,314,1.544585987
456,69,525,119,497,-378,45,64,2880,463,316,1.465189873
366,409,775,495,339,156,69,202,13938,462,375,1.232
99,321,420,183,97,86,168,294,49392,419,389,1.077120823
92,252,344,11,43,-32,336,173,58128,176,218,0.80733945
122,335,457,373,61,312,65,263,17095,184,179,1.027932961
387,377,764,273,268,5,128,374,47872,23,155,0.148387097
456,438,894,248,430,-182,55,217,11935,75,341,0.219941349
125,328,453,245,203,42,35,180,6300,319,99,3.222222222
188,159,347,15,211,-196,268,148,39664,459,26,17.65384615
212,354,566,145,226,-81,283,245,69335,225,402,0.559701493
28,265,293,126,64,62,385,158,60830,57,81,0.703703704
287,395,682,42,354,-312,227,48,10896,406,186,2.182795699
374,104,478,59,276,-217,355,497,176435,423,199,2.125628141
466,102,568,456,305,151,299,377,112723,36,253,0.14229249
389,243,632,409,186,223,71,490,34790,78,276,0.282608696
221,332,553,368,228,140,197,197,38809,119,78,1.525641026
151,425,576,138,354,-216,354,305,107970,267,493,0.54158215
109,139,248,427,170,257,287,334,95858,488,320,1.525
333,133,466,415,178,237,116,454,52664,147,233,0.630901288
48,243,291,393,458,-65,452,197,89044,351,96,3.65625
359,245,604,464,385,79,191,204,38964,189,445,0.424719101
99,121,220,235,470,-235,202,200,40400,326,353,0.923512748
240,36,276,427,396,31,56,328,18368,357,337,1.059347181
80,69,149,172,243,-71,50,405,20250,442,296,1.493243243
94,410,504,370,478,-108,51,427,21777,36,208,0.173076923
106,166,272,469,175,294,394,170,66980,414,160,2.5875
401,363,764,372,443,-71,274,59,16166,195,471,0.414012739
98,60,158,307,169,138,493,423,208539,459,406,1.130541872
398,377,775,165,47,118,468,401,187668,209,442,0.472850679
364,162,526,379,45,334,168,310,52080,252,470,0.536170213
242,88,330,275,344,-69,19,191,3629,150,184,0.815217391
439,336,775,145,204,-59,320,162,51840,40,64,0.625
294,124,418,210,24,186,155,478,74090,383,325,1.178461538
287,477,764,165,261,-96,81,462,37422,477,20,23.85
464,280,744,158,336,-178,495,231,114345,197,48,4.104166667
419,479,898,211,250,-39,57,123,7011,467,470,0.993617021
140,118,258,401,352,49,45,402,18090,355,52,6.826923077
426,56,482,64,141,-77,323,395,127585,339,16,21.1875
271,482,753,274,445,-171,269,129,34701,72,138,0.52173913
351,87,438,295,218,77,467,264,123288,408,157,2.598726115
237,414,651,246,310,-64,348,279,97092,298,84,3.547619048
217,465,682,304,21,283,177,142,25134,158,100,1.58
104,452,556,368,55,313,281,265,74465,474,164,2.890243902
37,76,113,349,89,260,149,314,46786,422,343,1.2303207
272,403,675,450,315,135,419,458,191902,69,133,0.518796992
173,93,266,322,425,-103,123,270,33210,481,195,2.466666667
342,378,720,253,251,2,453,335,151755,341,239,1.426778243
86,327,413,226,311,-85,16,30,480,129,277,0.465703971
466,277,743,191,32,159,447,317,141699,144,390,0.369230769
382,423,805,238,385,-147,453,213,96489,47,167,0.281437126
323,143,466,268,237,31,123,389,47847,270,445,0.606741573
157,234,391,199,57,142,376,413,155288,466,454,1.026431718
404,87,491,338,402,-64,313,219,68547,337,205,1.643902439
161,222,383,166,373,-207,77,208,16016,167,185,0.902702703
418,42,460,492,411,81,394,190,74860,473,447,1.058165548
204,170,374,160,51,109,289,152,43928,213,252,0.845238095
255,125,380,259,190,69,186,316,58776,231,408,0.566176471
104,69,173,391,159,232,150,30,4500,262,369,0.7100271
451,255,706,282,21,261,313,236,73868,489,390,1.253846154
292,456,748,219,368,-149,408,319,130152,10,75,0.133333333
426,37,463,183,172,11,272,289,78608,416,172,2.418604651
22,291,313,377,455,-78,109,365,39785,39,410,0.095121951
30,360,390,330,384,-54,73,246,17958,231,74,3.121621622
154,317,471,91,429,-338,264,116,30624,41,301,0.136212625
295,61,356,463,228,235,227,31,7037,192,386,0.497409326
410,116,526,370,204,166,366,161,58926,110,474,0.232067511
75,440,515,151,16,135,247,155,38285,96,360,0.266666667
407,407,814,25,106,-81,247,11,2717,44,115,0.382608696
368,302,670,347,212,135,115,285,32775,256,224,1.142857143
146,275,421,274,410,-136,47,339,15933,66,167,0.395209581
374,251,625,260,399,-139,354,350,123900,196,455,0.430769231
341,57,398,351,276,75,316,381,120396,457,274,1.667883212
23,231,254,469,136,333,413,359,148267,304,118,2.576271186
88,154,242,126,168,-42,389,163,63407,439,36,12.19444444
434,427,861,262,467,-205,324,94,30456,36,113,0.318584071
344,483,827,247,159,88,486,295,143370,80,421,0.190023753
271,273,544,385,47,338,276,305,84180,188,493,0.381338742
459,341,800,13,415,-402,221,328,72488,341,243,1.403292181
155,399,554,190,295,-105,18,148,2664,41,74,0.554054054
182,239,421,66,257,-191,413,450,185850,424,111,3.81981982
48,38,86,374,483,-109,116,493,57188,446,471,0.946921444
376,389,765,228,392,-164,264,223,58872,66,249,0.265060241
407,406,813,378,369,9,365,152,55480,379,330,1.148484848
389,318,707,283,230,53,385,279,107415,57,76,0.75
346,15,361,103,302,-199,37,217,8029,303,225,1.346666667
134,458,592,142,376,-234,25,199,4975,276,169,1.633136095
156,488,644,394,50,344,125,393,49125,383,133,2.879699248
491,348,839,23,124,-101,55,369,20295,457,331,1.380664653
256,324,580,68,169,-101,83,243,20169,227,69,3.289855072
44,38,82,359,333,26,426,210,89460,391,72,5.430555556
195,101,296,483,458,25,299,388,116012,124,193,0.642487047
136,25,161,48,96,-48,229,323,73967,483,480,1.00625
316,327,643,431,106,325,191,340,64940,448,122,3.672131148
466,389,855,484,254,230,297,275,81675,496,368,1.347826087
17,369,386,486,70,416,183,301,55083,48,330,0.145454545
453,393,846,380,262,118,374,113,42262,83,466,0.178111588
122,266,388,341,486,-145,72,310,22320,161,211,0.763033175
81,395,476,99,442,-343,285,221,62985,477,295,1.616949153
57,364,421,421,122,299,108,65,7020,300,498,0.602409639
122,458,580,87,499,-412,59,348,20532,227,158,1.436708861
290,178,468,412,30,382,467,310,144770,90,291,0.309278351
337,343,680,24,36,-12,243,252,61236,400,182,2.197802198
145,478,623,429,156,273,146,91,13286,283,333,0.84984985
252,432,684,211,314,-103,285,445,126825,43,43,1
308,152,460,117,324,-207,221,60,13260,276,460,0.6
368,117,485,410,434,-24,162,355,57510,90,218,0.412844037
111,20,131,286,56,230,208,287,59696,438,141,3.106382979
80,361,441,464,337,127,467,371,173257,155,222,0.698198198
465,175,640,255,255,0,273,345,94185,60,469,0.12793177
424,276,700,185,128,57,211,270,56970,39,109,0.357798165
51,476,527,22,253,-231,132,251,33132,400,97,4.12371134
431,96,527,378,391,-13,401,290,116290,345,121,2.851239669
287,339,626,358,344,14,475,350,166250,440,255,1.725490196
261,468,729,275,434,-159,362,362,131044,441,396,1.113636364
162,433,595,254,176,78,432,81,34992,15,414,0.036231884
101,92,193,96,209,-113,112,129,14448,50,186,0.268817204
393,218,611,490,478,12,199,468,93132,201,66,3.045454545
27,60,87,333,317,16,221,197,43537,373,96,3.885416667
438,105,543,348,431,-83,147,268,39396,425,211,2.014218009
225,91,316,252,489,-237,237,84,19908,107,74,1.445945946
189,334,523,361,393,-32,261,25,6525,180,352,0.511363636
334,325,659,319,211,108,410,239,97990,209,351,0.595441595
213,289,502,137,491,-354,77,122,9394,195,143,1.363636364
297,90,387,470,220,250,368,210,77280,79,350,0.225714286
108,283,391,84,47,37,215,340,73100,150,84,1.785714286
72,481,553,60,236,-176,458,51,23358,327,334,0.979041916
478,431,909,75,180,-105,381,205,78105,191,49,3.897959184
226,450,676,498,256,242,396,120,47520,418,79,5.291139241
204,163,367,144,149,-5,396,349,138204,264,85,3.105882353
352,179,531,189,397,-208,84,437,36708,432,133,3.248120301
293,267,560,34,76,-42,383,359,137497,134,216,0.62037037
374,488,862,437,231,206,365,129,47085,87,58,1.5
386,120,506,331,276,55,235,317,74495,85,276,0.307971014
18,359,377,299,455,-156,92,335,30820,496,415,1.195180723
174,123,297,142,215,-73,225,55,12375,131,472,0.277542373
81,431,512,461,114,347,241,396,95436,409,315,1.298412698
335,120,455,311,457,-146,86,81,6966,59,320,0.184375
39,28,67,38,476,-438,282,245,69090,350,349,1.00286533
21,52,73,68,146,-78,12,182,2184,203,357,0.568627451
372,365,737,467,212,255,93,484,45012,287,185,1.551351351
473,362,835,53,195,-142,190,137,26030,79,151,0.523178808
323,320,643,206,36,170,46,500,23000,302,407,0.742014742
55,147,202,234,195,39,31,226,7006,290,119,2.43697479
217,438,655,357,248,109,209,249,52041,73,303,0.240924092
384,100,484,234,231,3,444,39,17316,485,40,12.125
102,95,197,353,291,62,217,268,58156,268,131,2.045801527
208,318,526,134,57,77,94,136,12784,455,192,2.369791667
68,281,349,468,108,360,250,255,63750,238,316,0.753164557
154,129,283,54,365,-311,187,232,43384,12,321,0.037383178
64,203,267,72,136,-64,255,492,125460,103,399,0.258145363
241,153,394,85,203,-118,313,442,138346,83,499,0.166332665
88,266,354,299,467,-168,55,36,1980,206,90,2.288888889
435,265,700,499,212,287,346,34,11764,116,406,0.285714286
304,462,766,333,284,49,67,341,22847,205,279,0.734767025
354,354,708,189,386,-197,149,334,49766,477,307,1.553745928
95,309,404,56,41,15,251,355,89105,483,149,3.241610738
347,158,505,217,443,-226,194,331,64214,355,427,0.831381733
229,390,619,464,339,125,343,144,49392,200,375,0.533333333
433,388,821,141,309,-168,168,87,14616,132,389,0.33933162
200,296,496,204,476,-272,234,216,50544,142,427,0.332552693
176,219,395,482,74,408,348,275,95700,331,196,1.68877551
293,52,345,23,419,-396,497,153,76041,19,157,0.121019108
286,393,679,74,91,-17,423,60,25380,415,133,3.120300752
195,382,577,202,61,141,474,406,192444,126,48,2.625
383,466,849,102,500,-398,388,215,83420,478,122,3.918032787
269,104,373,35,176,-141,158,186,29388,209,125,1.672
212,322,534,477,321,156,20,283,5660,367,340,1.079411765
316,430,746,281,107,174,330,491,162030,161,70,2.3
109,92,201,103,351,-248,154,312,48048,471,260,1.811538462
193,38,231,391,230,161,305,451,137555,162,260,0.623076923
99,79,178,139,34,105,55,444,24420,448,497,0.901408451
164,120,284,497,20,477,227,40,9080,303,99,3.060606061
324,355,679,147,76,71,98,105,10290,218,174,1.252873563
386,48,434,486,240,246,258,29,7482,477,88,5.420454545
422,370,792,110,455,-345,287,42,12054,416,202,2.059405941
341,205,546,462,75,387,153,106,16218,212,129,1.643410853
233,400,633,426,392,34,158,420,66360,450,418,1.076555024
187,39,226,115,92,23,13,302,3926,366,218,1.678899083
183,80,263,46,277,-231,483,435,210105,177,448,0.395089286
416,275,691,308,292,16,53,341,18073,170,400,0.425
352,139,491,314,105,209,226,228,51528,175,490,0.357142857
368,126,494,418,251,167,386,11,4246,138,357,0.386554622
245,171,416,326,302,24,294,169,49686,351,463,0.758099352
438,435,873,92,257,-165,309,383,118347,460,164,2.804878049
137,298,435,430,323,107,283,353,99899,499,35,14.25714286
487,401,888,116,181,-65,110,41,4510,482,19,25.36842105
419,348,767,130,491,-361,169,188,31772,312,392,0.795918367
178,190,368,125,154,-29,293,29,8497,382,192,1.989583333
139,491,630,486,351,135,20,447,8940,150,488,0.307377049
497,463,960,453,285,168,214,385,82390,200,131,1.526717557
106,199,305,194,268,-74,10,166,1660,317,384,0.825520833
413,94,507,258,434,-176,445,300,133500,104,263,0.395437262
35,447,482,284,384,-100,265,371,98315,354,137,2.583941606
341,490,831,367,149,218,149,383,57067,47,67,0.701492537
335,465,800,340,132,208,451,485,218735,120,390,0.307692308
277,370,647,255,185,70,486,304,147744,499,162,3.080246914
136,443,579,491,255,236,267,380,101460,263,205,1.282926829
99,214,313,50,153,-103,497,164,81508,46,54,0.851851852
411,444,855,72,479,-407,20,480,9600,101,218,0.463302752
282,188,470,429,177,252,211,469,98959,400,35,11.42857143
129,163,292,98,272,-174,392,27,10584,29,475,0.061052632
269,211,480,37,337,-300,35,497,17395,437,329,1.328267477
213,433,646,320,123,197,480,262,125760,295,72,4.097222222
238,201,439,280,239,41,441,330,145530,160,467,0.34261242
174,71,245,238,375,-137,394,491,193454,107,253,0.422924901
54,472,526,376,200,176,88,437,38456,348,16,21.75
109,262,371,188,141,47,355,244,86620,168,215,0.781395349
259,134,393,109,193,-84,76,361,27436,64,455,0.140659341
448,145,593,179,131,48,130,61,7930,241,363,0.663911846
483,66,549,479,348,131,443,280,124040,69,241,0.286307054
50,392,442,271,234,37,219,171,37449,379,356,1.064606742
120,306,426,267,100,167,47,199,9353,449,96,4.677083333
376,16,392,313,418,-105,461,336,154896,65,442,0.147058824
152,110,262,481,361,120,23,415,9545,424,298,1.422818792
87,251,338,90,255,-165,190,254,48260,432,18,24
492,355,847,489,15,474,475,34,16150,488,42,11.61904762
329,94,423,133,77,56,276,186,51336,454,383,1.18537859
38,378,416,419,131,288,483,448,216384,446,432,1.032407407
53,421,474,141,107,34,492,310,152520,457,443,1.031602709
365,447,812,207,337,-130,404,96,38784,480,447,1.073825503
413,161,574,136,306,-170,27,396,10692,445,494,0.900809717
235,60,295,40,494,-454,326,20,6520,119,92,1.293478261
370,490,860,252,252,0,363,365,132495,453,468,0.967948718
345,21,366,65,293,-228,401,190,76190,143,31,4.612903226
369,428,797,148,144,4,264,302,79728,239,112,2.133928571
333,481,814,304,463,-159,460,469,215740,446,133,3.353383459
224,418,642,476,125,351,19,235,4465,464,56,8.285714286
134,54,188,467,482,-15,343,475,162925,11,191,0.057591623
486,228,714,341,360,-19,111,298,33078,342,76,4.5
479,114,593,86,310,-224,235,376,88360,351,450,0.78
144,318,462,215,218,-3,54,374,20196,172,65,2.646153846
115,273,388,370,142,228,45,431,19395,61,53,1.150943396
189,85,274,447,67,380,108,28,3024,28,237,0.11814346
62,470,532,298,321,-23,151,498,75198,108,61,1.770491803
109,286,395,174,457,-283,416,111,46176,251,19,13.21052632
203,485,688,411,494,-83,144,176,25344,120,296,0.405405405
110,408,518,315,384,-69,477,329,156933,277,380,0.728947368
202,499,701,189,417,-228,144,182,26208,276,283,0.975265018
176,297,473,94,110,-16,364,324,117936,448,454,0.986784141
316,257,573,20,225,-205,196,480,94080,67,300,0.223333333
34,57,91,218,249,-31,167,393,65631,337,265,1.271698113
15,67,82,188,104,84,176,309,54384,210,206,1.019417476
51,361,412,230,320,-90,356,405,144180,403,162,2.487654321
247,413,660,124,312,-188,380,477,181260,270,139,1.942446043
365,78,443,139,417,-278,425,498,211650,387,261,1.482758621
42,172,214,440,102,338,118,193,22774,440,205,2.146341463
73,426,499,143,117,26,368,318,117024,234,259,0.903474903
49,279,328,215,437,-222,449,338,151762,374,280,1.335714286
339,189,528,460,76,384,461,201,92661,165,378,0.436507937
263,86,349,368,177,191,241,496,119536,357,290,1.231034483
286,64,350,328,261,67,313,432,135216,154,87,1.770114943
111,63,174,54,463,-409,458,240,109920,419,28,14.96428571
470,403,873,487,296,191,322,313,100786,489,415,1.178313253
266,352,618,370,118,252,351,492,172692,488,333,1.465465465
42,275,317,370,382,-12,289,415,119935,469,162,2.895061728
427,86,513,409,301,108,161,381,61341,418,154,2.714285714
218,334,552,247,28,219,209,134,28006,458,167,2.74251497
466,213,679,39,46,-7,127,371,47117,280,236,1.186440678
20,409,429,452,89,363,354,329,116466,21,101,0.207920792
266,233,499,101,376,-275,317,497,157549,475,247,1.923076923
435,343,778,464,161,303,46,465,21390,62,38,1.631578947
144,195,339,225,346,-121,182,60,10920,370,423,0.874704492
339,462,801,397,418,-21,371,84,31164,326,386,0.844559585
237,51,288,217,258,-41,386,247,95342,402,438,0.917808219
408,256,664,213,140,73,246,268,65928,374,178,2.101123596
69,461,530,211,27,184,190,281,53390,454,341,1.331378299
367,173,540,486,414,72,325,152,49400,457,160,2.85625
109,480,589,258,466,-208,96,249,23904,475,126,3.76984127
99,459,558,154,65,89,76,486,36936,370,23,16.08695652
394,419,813,279,142,137,457,100,45700,396,57,6.947368421
499,112,611,46,396,-350,203,225,45675,80,18,4.444444444
225,169,394,293,400,-107,30,276,8280,174,367,0.474114441
345,243,588,360,255,105,38,457,17366,423,232,1.823275862
60,101,161,152,129,23,159,294,46746,152,271,0.560885609
144,254,398,186,397,-211,257,76,19532,70,272,0.257352941
57,315,372,212,112,100,174,95,16530,146,350,0.417142857
228,402,630,139,271,-132,236,354,83544,133,196,0.678571429
180,479,659,166,18,148,136,395,53720,80,477,0.167714885
15,74,89,130,443,-313,448,441,197568,220,343,0.641399417
497,21,518,310,263,47,84,178,14952,273,62,4.403225806
205,260,465,439,423,16,340,285,96900,249,274,0.908759124
398,456,854,229,376,-147,316,391,123556,246,31,7.935483871
257,201,458,197,160,37,324,362,117288,128,453,0.282560706
199,223,422,241,422,-181,346,322,111412,196,356,0.550561798
311,123,434,388,205,183,385,488,187880,365,417,0.87529976
158,160,318,381,279,102,183,494,90402,10,233,0.042918455
48,66,114,79,20,59,286,214,61204,416,471,0.883227176
423,227,650,108,335,-227,284,188,53392,393,49,8.020408163
413,391,804,469,99,370,269,196,52724,304,404,0.752475248
187,247,434,264,244,20,149,62,9238,283,325,0.870769231
194,155,349,414,404,10,78,323,25194,378,164,2.304878049
475,187,662,83,218,-135,189,120,22680,188,201,0.935323383
294,360,654,74,175,-101,498,276,137448,237,403,0.58808933
93,66,159,310,85,225,166,365,60590,215,77,2.792207792
59,397,456,408,308,100,68,269,18292,231,345,0.669565217
116,51,167,227,223,4,265,285,75525,284,428,0.663551402
57,453,510,119,478,-359,83,412,34196,126,80,1.575
480,357,837,423,62,361,388,456,176928,250,271,0.922509225
421,251,672,16,461,-445,16,216,3456,232,266,0.872180451
124,44,168,452,168,284,219,95,20805,473,288,1.642361111
80,298,378,111,265,-154,194,59,11446,115,475,0.242105263
179,276,455,175,118,57,477,296,141192,299,190,1.573684211
250,441,691,166,23,143,34,323,10982,200,259,0.772200772
379,486,865,163,206,-43,126,188,23688,36,216,0.166666667
488,500,988,64,446,-382,35,389,13615,33,119,0.277310924
241,459,700,354,164,190,10,83,830,382,450,0.848888889
474,46,520,414,369,45,426,70,29820,313,90,3.477777778
18,269,287,375,481,-106,34,64,2176,143,401,0.356608479
193,172,365,100,372,-272,132,464,61248,134,164,0.817073171
216,36,252,43,327,-284,290,472,136880,52,450,0.115555556
406,302,708,139,496,-357,137,358,49046,451,307,1.469055375
105,407,512,496,109,387,460,327,150420,32,215,0.148837209
480,444,924,91,58,33,252,183,46116,265,396,0.669191919
74,87,161,353,476,-123,87,135,11745,246,353,0.696883853
121,393,514,205,309,-104,20,113,2260,48,20,2.4
400,191,591,417,190,227,294,276,81144,37,487,0.075975359
161,89,250,30,54,-24,220,107,23540,281,126,2.23015873
282,307,589,103,481,-378,405,270,109350,408,157,2.598726115
404,104,508,83,330,-247,62,66,4092,247,130,1.9
373,55,428,373,261,112,485,369,178965,220,401,0.548628429
452,251,703,389,311,78,331,425,140675,163,470,0.346808511
287,361,648,111,87,24,247,221,54587,382,364,1.049450549
79,397,476,180,316,-136,399,45,17955,95,117,0.811965812
263,56,319,453,178,275,89,493,43877,366,62,5.903225806
207,97,304,94,494,-400,326,243,79218,183,27,6.777777778
496,210,706,114,193,-79,458,10,4580,161,45,3.577777778
51,203,254,103,401,-298,213,38,8094,446,61,7.31147541
304,171,475,236,404,-168,59,378,22302,263,52,5.057692308
183,341,524,302,407,-105,344,348,119712,326,311,1.048231511
154,35,189,329,199,130,92,169,15548,70,53,1.320754717
242,427,669,192,464,-272,419,161,67459,448,216,2.074074074
414,308,722,34,144,-110,445,51,22695,138,381,0.362204724
358,281,639,474,302,172,363,437,158631,132,361,0.36565097
191,475,666,422,297,125,293,79,23147,41,299,0.137123746
188,35,223,309,222,87,421,385,162085,180,425,0.423529412
114,44,158,209,130,79,175,443,77525,278,118,2.355932203
69,494,563,220,235,-15,144,30,4320,197,345,0.571014493
23,122,145,174,371,-197,456,119,54264,176,203,0.866995074
156,234,390,453,402,51,289,360,104040,398,118,3.372881356
459,103,562,46,341,-295,165,180,29700,87,402,0.21641791
411,128,539,359,307,52,15,121,1815,414,32,12.9375
417,117,534,478,386,92,163,202,32926,441,233,1.892703863
17,493,510,384,230,154,469,15,7035,122,473,0.257928118
119,409,528,226,10,216,362,150,54300,448,129,3.472868217
405,474,879,407,122,285,281,479,134599,145,110,1.318181818
331,320,651,291,200,91,463,339,156957,419,244,1.717213115
197,432,629,317,91,226,115,296,34040,385,119,3.235294118
436,163,599,418,185,233,336,297,99792,231,253,0.913043478
221,159,380,260,83,177,105,258,27090,309,145,2.131034483
72,91,163,88,63,25,368,210,77280,40,93,0.430107527
264,253,517,305,203,102,455,276,125580,176,455,0.386813187
407,350,757,334,313,21,393,316,124188,131,219,0.598173516
367,497,864,111,130,-19,144,277,39888,19,149,0.127516779
370,272,642,177,296,-119,24,310,7440,353,463,0.762419006
271,493,764,453,114,339,85,178,15130,360,120,3
466,425,891,100,362,-262,447,433,193551,327,247,1.32388664
87,461,548,259,354,-95,365,356,129940,259,214,1.210280374
189,231,420,358,234,124,419,459,192321,199,414,0.480676329
126,383,509,352,308,44,246,356,87576,231,479,0.482254697
105,309,414,139,137,2,207,436,90252,257,321,0.800623053
425,267,692,440,452,-12,256,322,82432,242,200,1.21
425,199,624,186,167,19,27,52,1404,81,312,0.259615385
229,480,709,377,102,275,227,143,32461,180,470,0.382978723
497,91,588,21,314,-293,488,329,160552,375,296,1.266891892
383,129,512,176,444,-268,126,344,43344,485,254,1.909448819
109,419,528,137,260,-123,158,224,35392,139,200,0.695
470,480,950,485,415,70,195,123,23985,31,402,0.077114428
26,192,218,222,182,40,482,352,169664,205,95,2.157894737
319,374,693,278,177,101,97,33,3201,368,371,0.991913747
33,388,421,321,60,261,188,240,45120,432,439,0.98405467
299,112,411,424,236,188,239,288,68832,93,392,0.237244898
74,407,481,424,248,176,210,91,19110,334,44,7.590909091
285,470,755,393,375,18,409,70,28630,463,448,1.033482143
77,454,531,59,228,-169,424,353,149672,82,269,0.304832714
371,369,740,348,452,-104,358,374,133892,200,343,0.583090379
252,344,596,186,240,-54,24,389,9336,309,22,14.04545455
383,268,651,320,54,266,175,310,54250,286,150,1.906666667
405,421,826,389,240,149,456,197,89832,320,495,0.646464646
420,34,454,192,487,-295,479,407,194953,175,268,0.652985075
377,287,664,28,446,-418,222,448,99456,239,240,0.995833333
338,260,598,207,473,-266,123,284,34932,395,233,1.69527897
262,466,728,428,165,263,300,495,148500,50,227,0.220264317
170,313,483,293,298,-5,87,70,6090,309,119,2.596638655
43,269,312,60,420,-360,111,456,50616,292,72,4.055555556
272,260,532,151,481,-330,398,472,187856,393,262,1.5
361,337,698,495,78,417,361,345,124545,302,296,1.02027027
230,387,617,427,319,108,308,374,115192,484,250,1.936
12,126,138,269,400,-131,159,158,25122,403,61,6.606557377
242,471,713,79,190,-111,488,306,149328,378,388,0.974226804
215,403,618,177,185,-8,484,160,77440,377,84,4.488095238
253,451,704,442,91,351,219,164,35916,38,351,0.108262108
446,37,483,414,41,373,375,379,142125,133,29,4.586206897
18,193,211,132,160,-28,52,15,780,437,132,3.310606061
387,428,815,202,436,-234,257,453,116421,485,364,1.332417582
306,475,781,296,469,-173,12,418,5016,347,318,1.091194969
383,35,418,244,20,224,69,117,8073,106,107,0.990654206
253,325,578,211,417,-206,458,392,179536,114,216,0.527777778
296,152,448,73,490,-417,279,419,116901,34,85,0.4
180,293,473,68,227,-159,247,402,99294,94,168,0.55952381
466,243,709,392,291,101,330,442,145860,223,57,3.912280702
312,235,547,395,41,354,339,494,167466,74,360,0.205555556
356,459,815,173,442,-269,305,389,118645,192,87,2.206896552
221,266,487,432,242,190,261,10,2610,140,194,0.721649485
138,324,462,329,367,-38,142,271,38482,60,385,0.155844156
84,127,211,262,449,-187,14,283,3962,77,175,0.44
307,94,401,65,276,-211,30,286,8580,11,430,0.025581395
376,286,662,381,73,308,492,269,132348,296,31,9.548387097
419,439,858,143,293,-150,287,482,138334,249,50,4.98
269,362,631,472,315,157,11,150,1650,235,340,0.691176471
448,495,943,79,339,-260,454,188,85352,384,258,1.488372093
377,410,787,218,475,-257,260,291,75660,177,45,3.933333333
170,430,600,454,384,70,266,235,62510,232,168,1.380952381
270,278,548,415,49,366,231,182,42042,136,446,0.304932735
499,55,554,213,218,-5,245,229,56105,98,288,0.340277778
443,239,682,281,12,269,413,389,160657,308,345,0.892753623
330,27,357,414,305,109,478,201,96078,350,299,1.170568562
66,487,553,340,262,78,323,392,126616,88,497,0.177062374
48,132,180,101,157,-56,188,186,34968,226,33,6.848484848
454,477,931,256,391,-135,146,94,13724,491,376,1.305851064
498,243,741,270,98,172,209,151,31559,455,106,4.29245283
246,51,297,13,113,-100,438,482,211116,259,495,0.523232323
458,366,824,133,161,-28,84,349,29316,157,15,10.46666667
173,50,223,141,14,127,450,102,45900,48,359,0.133704735
78,147,225,17,193,-176,138,73,10074,476,454,1.04845815
447,287,734,344,357,-13,214,241,51574,154,279,0.551971326
58,426,484,493,388,105,154,347,53438,169,291,0.580756014
497,462,959,401,223,178,372,191,71052,17,269,0.063197026
443,111,554,234,226,8,324,32,10368,247,38,6.5
96,322,418,274,463,-189,490,376,184240,273,312,0.875
342,119,461,440,197,243,392,41,16072,311,324,0.959876543
476,439,915,336,287,49,320,433,138560,365,269,1.356877323
157,262,419,494,139,355,176,153,26928,235,386,0.60880829
192,63,255,359,452,-93,123,459,56457,388,370,1.048648649
181,270,451,179,50,129,251,48,12048,61,420,0.145238095
23,240,263,39,381,-342,99,300,29700,64,23,2.782608696
318,324,642,205,229,-24,476,227,108052,233,35,6.657142857
29,70,99,416,394,22,423,45,19035,255,287,0.888501742
305,30,335,456,244,212,462,257,118734,339,455,0.745054945
480,425,905,37,493,-456,146,110,16060,410,21,19.52380952
237,472,709,80,106,-26,325,92,29900,351,227,1.546255507
277,146,423,229,83,146,338,150,50700,130,375,0.346666667
267,281,548,317,298,19,439,28,12292,431,406,1.061576355
201,177,378,120,216,-96,130,189,24570,52,154,0.337662338
440,240,680,150,421,-271,240,349,83760,481,314,1.531847134
389,126,515,116,247,-131,343,442,151606,275,203,1.354679803
341,204,545,487,349,138,116,68,7888,328,287,1.142857143
26,453,479,367,166,201,280,480,134400,341,261,1.30651341
314,103,417,143,240,-97,170,293,49810,117,493,0.237322515
391,418,809,483,486,-3,92,142,13064,383,462,0.829004329
459,135,594,295,60,235,415,111,46065,415,134,3.097014925
352,91,443,343,168,175,26,105,2730,492,394,1.248730964
293,362,655,138,313,-175,171,80,13680,330,63,5.238095238
306,264,570,309,493,-184,352,24,8448,286,410,0.697560976
44,389,433,463,301,162,247,384,94848,447,157,2.847133758
422,210,632,402,27,375,51,224,11424,493,242,2.037190083
481,287,768,223,276,-53,443,274,121382,32,221,0.14479638
417,193,610,102,98,4,193,308,59444,71,260,0.273076923
268,87,355,55,385,-330,387,303,117261,352,24,14.66666667
119,452,571,219,386,-167,276,87,24012,185,14,13.21428571
267,249,516,370,456,-86,334,355,118570,436,290,1.503448276
134,243,377,297,191,106,309,368,113712,84,161,0.52173913
206,25,231,342,277,65,486,17,8262,480,81,5.925925926
239,169,408,241,220,21,113,19,2147,60,239,0.251046025
52,277,329,201,178,23,270,236,63720,69,254,0.271653543
296,438,734,404,116,288,464,441,204624,116,272,0.426470588
16,165,181,415,45,370,330,202,66660,64,209,0.306220096
237,380,617,487,388,99,180,307,55260,35,14,2.5
174,456,630,423,236,187,94,298,28012,89,213,0.417840376
253,490,743,468,185,283,184,256,47104,429,465,0.922580645
56,180,236,311,491,-180,494,337,166478,73,447,0.163310962
253,244,497,497,191,306,405,414,167670,250,336,0.744047619
305,234,539,166,59,107,123,411,50553,162,71,2.281690141
274,328,602,243,143,100,184,131,24104,78,410,0.190243902
201,345,546,208,185,23,335,92,30820,292,467,0.625267666
239,191,430,404,189,215,282,430,121260,344,454,0.757709251
398,211,609,211,227,-16,337,316,106492,447,281,1.590747331
149,12,161,421,163,258,49,97,4753,179,285,0.628070175
19,270,289,112,132,-20,109,80,8720,412,210,1.961904762
330,102,432,181,111,70,370,109,40330,14,331,0.042296073
173,222,395,55,323,-268,118,125,14750,52,312,0.166666667
287,414,701,64,287,-223,29,171,4959,346,16,21.625
58,86,144,59,244,-185,273,44,12012,155,282,0.54964539
106,115,221,96,320,-224,293,45,13185,360,116,3.103448276
198,19,217,473,361,112,320,118,37760,181,441,0.410430839
317,388,705,154,465,-311,228,90,20520,23,322,0.071428571
62,85,147,203,379,-176,459,332,152388,440,146,3.01369863
190,276,466,191,480,-289,16,358,5728,74,435,0.170114943
270,373,643,257,158,99,79,69,5451,51,464,0.109913793
268,187,455,19,217,-198,387,460,178020,57,179,0.318435754
368,29,397,18,69,-51,148,416,61568,286,177,1.615819209
246,249,495,230,441,-211,34,63,2142,94,329,0.285714286
22,366,388,301,421,-120,466,301,140266,181,400,0.4525
220,191,411,154,51,103,309,285,88065,494,376,1.313829787
388,173,561,273,150,123,416,81,33696,231,455,0.507692308
319,166,485,56,77,-21,360,247,88920,353,294,1.200680272
114,290,404,293,127,166,462,493,227766,282,459,0.614379085
489,490,979,499,159,340,483,42,20286,47,99,0.474747475
463,231,694,139,229,-90,54,262,14148,339,356,0.952247191
428,368,796,77,304,-227,500,322,161000,275,49,5.612244898
155,328,483,345,394,-49,103,442,45526,298,142,2.098591549
366,377,743,389,223,166,96,148,14208,202,237,0.852320675
85,168,253,24,343,-319,341,421,143561,487,70,6.957142857
430,247,677,351,253,98,381,11,4191,215,66,3.257575758
430,299,729,317,434,-117,314,176,55264,152,69,2.202898551
24,270,294,335,453,-118,93,419,38967,378,157,2.407643312
377,119,496,284,64,220,89,487,43343,360,261,1.379310345
62,53,115,471,96,375,19,305,5795,306,297,1.03030303
402,433,835,380,469,-89,157,241,37837,165,488,0.338114754
497,376,873,272,349,-77,27,231,6237,443,448,0.988839286
246,246,492,466,150,316,464,278,128992,348,29,12
174,73,247,426,316,110,233,122,28426,350,443,0.79006772
362,251,613,360,487,-127,322,202,65044,265,157,1.687898089
258,473,731,231,246,-15,354,58,20532,444,182,2.43956044
259,106,365,288,446,-158,405,260,105300,431,168,2.56547619
250,331,581,74,235,-161,485,218,105730,344,410,0.83902439
466,73,539,219,166,53,76,279,21204,29,210,0.138095238
433,48,481,152,111,41,230,108,24840,285,331,0.86102719
248,65,313,445,97,348,429,56,24024,217,155,1.4
224,184,408,55,414,-359,500,161,80500,203,112,1.8125
156,277,433,417,14,403,24,454,10896,270,69,3.913043478
376,138,514,127,361,-234,418,349,145882,372,175,2.125714286
295,121,416,489,150,339,319,369,117711,483,52,9.288461538
262,314,576,12,233,-221,28,427,11956,472,208,2.269230769
171,375,546,290,25,265,311,317,98587,30,315,0.095238095
388,418,806,292,381,-89,106,278,29468,72,202,0.356435644
52,496,548,405,235,170,21,396,8316,359,263,1.365019011
486,367,853,143,299,-156,108,346,37368,80,403,0.198511166
261,200,461,127,480,-353,348,314,109272,28,122,0.229508197
373,242,615,309,78,231,417,280,116760,133,499,0.266533066
123,211,334,371,47,324,308,209,64372,20,189,0.105820106
288,11,299,323,32,291,241,135,32535,306,228,1.342105263
349,340,689,54,28,26,405,277,112185,311,71,4.38028169
36,296,332,484,437,47,343,12,4116,192,302,0.635761589
371,250,621,177,91,86,333,346,115218,302,146,2.068493151
272,144,416,446,348,98,267,105,28035,122,136,0.897058824
200,107,307,95,45,50,20,156,3120,387,136,2.845588235
481,158,639,268,196,72,277,68,18836,449,349,1.286532951
56,296,352,366,96,270,136,36,4896,73,147,0.496598639
300,308,608,88,151,-63,20,78,1560,453,222,2.040540541
27,339,366,116,266,-150,29,328,9512,259,438,0.591324201
84,139,223,320,82,238,313,121,37873,137,288,0.475694444
428,177,605,472,272,200,50,280,14000,292,300,0.973333333
373,205,578,56,181,-125,99,269,26631,370,209,1.770334928
128,125,253,178,318,-140,95,237,22515,320,494,0.647773279
38,242,280,329,369,-40,450,479,215550,34,421,0.080760095
260,46,306,474,12,462,202,73,14746,167,147,1.136054422
52,251,303,23,423,-400,260,73,18980,414,316,1.310126582
149,427,576,84,185,-101,451,246,110946,192,491,0.391038697
344,395,739,404,498,-94,478,160,76480,192,319,0.601880878
470,339,809,205,402,-197,11,146,1606,344,278,1.237410072
144,38,182,414,384,30,92,246,22632,254,203,1.251231527
273,18,291,238,344,-106,110,146,16060,254,331,0.767371601
381,344,725,466,396,70,124,344,42656,240,478,0.50209205
489,494,983,463,439,24,183,188,34404,450,481,0.935550936
252,336,588,265,292,-27,196,361,70756,210,353,0.59490085
354,104,458,382,375,7,304,476,144704,125,363,0.344352617
422,481,903,217,389,-172,173,429,74217,207,11,18.81818182
122,499,621,473,298,175,314,191,59974,354,78,4.538461538
108,152,260,222,231,-9,494,73,36062,456,23,19.82608696
439,479,918,129,411,-282,283,482,136406,309,107,2.887850467
151,149,300,455,432,23,390,411,160290,235,375,0.626666667
177,304,481,431,412,19,370,444,164280,54,368,0.14673913
273,431,704,220,62,158,240,338,81120,145,114,1.271929825
341,425,766,61,364,-303,39,157,6123,279,206,1.354368932
79,268,347,289,405,-116,155,188,29140,368,166,2.21686747
283,228,511,88,25,63,379,436,165244,254,277,0.916967509
445,183,628,446,79,367,361,221,79781,37,467,0.079229122
29,489,518,346,252,94,68,374,25432,488,335,1.456716418
318,264,582,193,186,7,120,62,7440,132,362,0.364640884
105,264,369,306,256,50,142,365,51830,100,421,0.237529691
40,95,135,188,325,-137,267,195,52065,239,462,0.517316017
364,208,572,413,238,175,357,415,148155,417,55,7.581818182
277,149,426,307,59,248,444,301,133644,85,112,0.758928571
149,239,388,278,146,132,90,429,38610,371,300,1.236666667
311,213,524,33,447,-414,427,402,171654,371,483,0.768115942
493,368,861,78,130,-52,312,238,74256,188,271,0.693726937
168,303,471,216,16,200,267,256,68352,420,364,1.153846154
40,490,530,314,416,-102,297,119,35343,170,136,1.25
175,435,610,176,36,140,87,275,23925,360,489,0.736196319
434,183,617,396,353,43,343,434,148862,175,422,0.414691943
79,286,365,477,362,115,124,123,15252,78,449,0.173719376
90,44,134,325,368,-43,401,307,123107,417,451,0.924611973
42,452,494,96,243,-147,393,278,109254,241,123,1.959349593
186,93,279,191,320,-129,75,270,20250,44,223,0.197309417
127,192,319,474,423,51,282,106,29892,409,304,1.345394737
39,494,533,387,473,-86,129,349,45021,260,16,16.25
475,345,820,328,160,168,33,38,1254,495,352,1.40625
303,154,457,361,167,194,153,485,74205,375,254,1.476377953
382,431,813,420,74,346,319,268,85492,106,387,0.273901809
245,165,410,492,331,161,237,61,14457,151,485,0.311340206
255,264,519,399,278,121,407,467,190069,61,342,0.178362573
480,295,775,42,460,-418,198,229,45342,453,181,2.502762431
149,128,277,381,95,286,176,159,27984,350,99,3.535353535
368,368,736,377,494,-117,472,291,137352,39,371,0.105121294
231,475,706,208,50,158,106,229,24274,461,228,2.021929825
53,80,133,413,130,283,368,256,94208,349,41,8.512195122
415,174,589,454,213,241,285,151,43035,94,59,1.593220339
481,211,692,255,239,16,368,453,166704,178,462,0.385281385
325,103,428,466,333,133,103,381,39243,240,115,2.086956522
65,19,84,249,377,-128,76,374,28424,399,371,1.075471698
60,100,160,480,164,316,391,405,158355,255,162,1.574074074
150,63,213,303,411,-108,154,119,18326,366,84,4.357142857
358,111,469,45,264,-219,291,313,91083,351,407,0.862407862
416,493,909,455,159,296,328,373,122344,445,305,1.459016393
142,314,456,332,251,81,338,330,111540,417,22,18.95454545
227,457,684,170,326,-156,323,205,66215,356,249,1.429718876
274,62,336,36,243,-207,142,439,62338,327,485,0.674226804
53,284,337,10,24,-14,221,351,77571,262,452,0.579646018
281,300,581,461,244,217,182,333,60606,367,61,6.016393443
424,184,608,347,25,322,476,338,160888,403,296,1.361486486
331,359,690,264,221,43,338,204,68952,441,274,1.609489051
388,348,736,384,374,10,484,264,127776,113,386,0.292746114
129,312,441,281,322,-41,140,369,51660,173,44,3.931818182
409,269,678,104,30,74,291,156,45396,255,285,0.894736842
197,27,224,78,208,-130,313,341,106733,160,373,0.428954424
133,363,496,91,279,-188,171,423,72333,458,72,6.361111111
261,427,688,476,492,-16,340,281,95540,176,298,0.590604027
232,324,556,323,467,-144,403,427,172081,251,165,1.521212121
135,92,227,386,104,282,364,379,137956,451,411,1.097323601
35,275,310,466,69,397,192,351,67392,389,17,22.88235294
135,136,271,45,266,-221,268,139,37252,239,57,4.192982456
176,156,332,320,490,-170,300,192,57600,291,319,0.912225705
51,121,172,244,283,-39,265,262,69430,124,74,1.675675676
203,199,402,103,149,-46,120,354,42480,206,373,0.55227882
253,349,602,271,286,-15,165,225,37125,252,258,0.976744186
401,254,655,381,498,-117,218,236,51448,285,250,1.14
134,316,450,24,172,-148,41,410,16810,218,146,1.493150685
75,415,490,316,139,177,289,208,60112,23,64,0.359375
153,260,413,460,254,206,121,438,52998,299,498,0.600401606
91,490,581,343,370,-27,268,284,76112,224,182,1.230769231
277,192,469,270,178,92,211,74,15614,432,218,1.981651376
294,99,393,236,329,-93,114,348,39672,221,40,5.525
452,235,687,196,88,108,399,304,121296,234,352,0.664772727
437,391,828,491,332,159,175,94,16450,297,275,1.08
139,177,316,286,237,49,351,490,171990,138,58,2.379310345
126,341,467,88,108,-20,476,251,119476,443,380,1.165789474
209,481,690,171,395,-224,72,237,17064,262,367,0.713896458
411,39,450,89,418,-329,36,449,16164,54,77,0.701298701
329,367,696,298,376,-78,389,303,117867,225,325,0.692307692
108,436,544,352,307,45,88,225,19800,26,364,0.071428571
27,23,50,369,234,135,233,386,89938,239,50,4.78
138,424,562,454,191,263,297,370,109890,225,313,0.71884984
400,176,576,366,369,-3,101,471,47571,377,308,1.224025974
143,76,219,80,12,68,95,88,8360,63,476,0.132352941
280,225,505,114,327,-213,138,142,19596,124,124,1
491,298,789,377,184,193,27,380,10260,223,402,0.554726368
459,392,851,189,402,-213,219,184,40296,191,452,0.422566372
60,45,105,106,17,89,318,306,97308,181,96,1.885416667
285,152,437,105,146,-41,179,91,16289,358,322,1.111801242
377,101,478,427,428,-1,283,365,103295,119,424,0.280660377
310,30,340,68,296,-228,45,493,22185,420,215,1.953488372
293,269,562,467,304,163,470,122,57340,315,203,1.551724138
385,278,663,44,171,-127,56,293,16408,67,129,0.519379845
139,165,304,205,375,-170,136,281,38216,390,478,0.815899582
339,21,360,83,426,-343,340,207,70380,67,381,0.175853018
166,314,480,47,249,-202,272,434,118048,396,491,0.806517312
492,380,872,51,35,16,392,76,29792,221,340,0.65
274,282,556,314,138,176,355,361,128155,408,289,1.411764706
323,285,608,476,361,115,372,92,34224,330,89,3.707865169
462,220,682,373,388,-15,339,30,10170,248,462,0.536796537
444,449,893,390,55,335,248,205,50840,140,181,0.773480663
413,21,434,278,244,34,36,157,5652,66,403,0.163771712
64,183,247,189,462,-273,94,61,5734,283,90,3.144444444
479,484,963,363,116,247,446,294,131124,366,142,2.577464789
364,392,756,327,145,182,311,92,28612,191,419,0.455847255
137,260,397,141,357,-216,83,292,24236,455,77,5.909090909
402,126,528,324,492,-168,259,188,48692,387,184,2.10326087
238,209,447,363,126,237,95,323,30685,221,152,1.453947368
25,154,179,282,323,-41,459,157,72063,463,274,1.689781022
470,156,626,367,359,8,104,255,26520,429,224,1.915178571
407,191,598,445,33,412,224,414,92736,12,47,0.255319149
67,318,385,448,487,-39,97,447,43359,442,51,8.666666667
173,69,242,289,400,-111,204,321,65484,110,423,0.260047281
309,193,502,484,437,47,463,263,121769,280,235,1.191489362
419,65,484,418,407,11,103,428,44084,488,12,40.66666667
61,356,417,467,338,129,231,255,58905,487,261,1.865900383
281,278,559,146,27,119,273,60,16380,16,411,0.03892944
22,378,400,309,176,133,42,247,10374,170,309,0.550161812
68,365,433,105,223,-118,309,159,49131,166,135,1.22962963
442,489,931,135,382,-247,264,136,35904,259,26,9.961538462
140,246,386,56,149,-93,178,91,16198,115,74,1.554054054
60,44,104,344,280,64,155,420,65100,427,32,13.34375
81,138,219,82,401,-319,474,302,143148,239,374,0.639037433
439,350,789,288,281,7,314,27,8478,74,458,0.161572052
302,483,785,409,355,54,10,348,3480,40,270,0.148148148
365,262,627,468,221,247,72,57,4104,415,352,1.178977273
109,250,359,63,476,-413,233,377,87841,171,216,0.791666667
95,422,517,363,342,21,24,257,6168,59,61,0.967213115
489,138,627,16,373,-357,155,95,14725,290,124,2.338709677
471,469,940,397,84,313,189,366,69174,266,443,0.600451467
298,106,404,160,301,-141,163,298,48574,223,415,0.537349398
238,280,518,479,67,412,420,494,207480,392,430,0.911627907
35,70,105,54,100,-46,81,437,35397,416,101,4.118811881
217,210,427,59,389,-330,75,436,32700,350,484,0.723140496
202,38,240,162,291,-129,151,442,66742,365,328,1.112804878
235,315,550,474,265,209,383,210,80430,470,391,1.202046036
343,239,582,356,186,170,137,425,58225,131,340,0.385294118
24,30,54,366,19,347,365,159,58035,345,224,1.540178571
410,460,870,401,346,55,324,332,107568,244,333,0.732732733
477,448,925,361,136,225,400,188,75200,302,334,0.904191617
160,56,216,245,47,198,158,289,45662,41,145,0.282758621
46,393,439,237,76,161,346,392,135632,31,114,0.271929825
238,492,730,313,74,239,323,60,19380,143,28,5.107142857
21,285,306,392,361,31,86,183,15738,147,315,0.466666667
14,93,107,228,55,173,30,97,2910,423,321,1.317757009
304,107,411,286,482,-196,177,420,74340,437,309,1.414239482
150,197,347,419,466,-47,282,254,71628,263,204,1.289215686
298,136,434,185,39,146,424,395,167480,166,30,5.533333333
387,452,839,33,365,-332,269,227,61063,39,102,0.382352941
396,362,758,214,95,119,97,323,31331,18,352,0.051136364
220,474,694,243,76,167,183,394,72102,109,289,0.37716263
81,457,538,56,218,-162,315,68,21420,217,12,18.08333333
248,223,471,496,290,206,490,330,161700,488,284,1.718309859
326,267,593,324,196,128,331,69,22839,26,132,0.196969697
489,171,660,296,114,182,480,374,179520,297,260,1.142307692
167,97,264,467,205,262,142,288,40896,331,370,0.894594595
485,453,938,450,275,175,26,226,5876,184,106,1.735849057
469,50,519,140,317,-177,135,88,11880,346,178,1.943820225
45,132,177,273,50,223,126,494,62244,246,383,0.64229765
500,359,859,332,253,79,242,260,62920,322,441,0.73015873
29,270,299,363,190,173,192,397,76224,439,267,1.644194757
246,249,495,84,193,-109,31,144,4464,378,299,1.264214047
433,474,907,201,493,-292,340,42,14280,439,45,9.755555556
405,268,673,133,274,-141,468,42,19656,297,208,1.427884615
422,153,575,261,426,-165,280,435,121800,482,220,2.190909091
215,378,593,402,146,256,220,339,74580,217,153,1.418300654
317,496,813,294,85,209,380,407,154660,309,91,3.395604396
479,104,583,133,449,-316,317,15,4755,120,326,0.36809816
68,67,135,14,231,-217,49,363,17787,12,384,0.03125
285,25,310,154,463,-309,268,67,17956,377,432,0.872685185
34,337,371,250,88,162,468,363,169884,401,226,1.774336283
216,233,449,485,155,330,315,39,12285,281,154,1.824675325
319,374,693,341,309,32,338,479,161902,127,479,0.265135699
280,340,620,296,376,-80,48,208,9984,402,312,1.288461538
219,293,512,380,470,-90,75,388,29100,41,448,0.091517857
219,367,586,330,43,287,307,26,7982,380,145,2.620689655
201,441,642,28,472,-444,104,73,7592,135,70,1.928571429
53,460,513,338,399,-61,407,285,115995,100,218,0.458715596
109,193,302,168,209,-41,333,344,114552,206,86,2.395348837
254,497,751,332,218,114,196,69,13524,348,412,0.844660194
394,129,523,33,324,-291,322,278,89516,68,378,0.17989418
170,468,638,305,213,92,412,338,139256,298,110,2.709090909
481,409,890,498,167,331,439,297,130383,403,419,0.961813842
23,303,326,245,250,-5,168,479,80472,220,200,1.1
183,269,452,102,488,-386,336,335,112560,305,119,2.56302521
149,30,179,102,492,-390,249,201,50049,126,200,0.63
391,313,704,33,408,-375,267,78,20826,232,431,0.538283063
76,226,302,268,108,160,366,477,174582,448,158,2.835443038
63,62,125,386,255,131,219,439,96141,146,257,0.568093385
458,75,533,49,419,-370,287,276,79212,345,421,0.819477435
376,231,607,269,255,14,293,186,54498,271,311,0.871382637
30,283,313,46,42,4,348,338,117624,228,82,2.780487805
144,176,320,50,286,-236,135,123,16605,106,208,0.509615385
82,392,474,448,496,-48,266,160,42560,358,366,0.978142077
398,82,480,395,467,-72,29,118,3422,456,125,3.648
217,134,351,340,160,180,497,356,176932,303,488,0.620901639
365,17,382,375,195,180,397,401,159197,306,342,0.894736842
179,210,389,52,372,-320,157,444,69708,273,182,1.5
291,414,705,159,168,-9,39,203,7917,107,340,0.314705882
345,432,777,84,159,-75,464,247,114608,273,60,4.55
439,204,643,79,127,-48,389,293,113977,274,298,0.919463087
261,104,365,20,336,-316,303,73,22119,109,313,0.348242812
128,223,351,396,323,73,456,93,42408,292,66,4.424242424
406,403,809,312,242,70,433,248,107384,231,352,0.65625
109,169,278,404,369,35,194,126,24444,167,497,0.336016097
206,367,573,439,318,121,440,62,27280,275,243,1.131687243
50,417,467,468,440,28,134,166,22244,131,435,0.301149425
487,58,545,312,333,-21,130,349,45370,328,170,1.929411765
378,288,666,310,500,-190,76,296,22496,412,107,3.85046729
218,383,601,442,274,168,401,342,137142,240,409,0.586797066
49,168,217,65,93,-28,61,11,671,152,381,0.398950131
438,149,587,27,431,-404,269,228,61332,277,492,0.56300813
338,20,358,495,382,113,242,71,17182,224,439,0.510250569
423,352,775,242,200,42,56,487,27272,56,299,0.18729097
281,296,577,266,236,30,112,340,38080,320,216,1.481481481
394,159,553,311,72,239,133,138,18354,337,467,0.721627409
34,143,177,424,339,85,226,161,36386,322,30,10.73333333
442,449,891,124,482,-358,303,391,118473,436,344,1.26744186
139,91,230,224,495,-271,496,323,160208,208,287,0.724738676
228,257,485,429,472,-43,14,283,3962,201,396,0.507575758
16,43,59,167,448,-281,172,382,65704,484,328,1.475609756
465,446,911,104,309,-205,199,150,29850,264,160,1.65
374,432,806,247,493,-246,144,320,46080,141,165,0.854545455
342,77,419,430,483,-53,218,276,60168,18,11,1.636363636
270,345,615,326,238,88,217,376,81592,198,60,3.3
461,299,760,47,417,-370,443,140,62020,488,381,1.280839895
417,383,800,345,69,276,419,95,39805,196,298,0.657718121
370,385,755,242,356,-114,319,340,108460,463,335,1.382089552
95,268,363,346,380,-34,459,214,98226,286,245,1.167346939
264,250,514,427,232,195,485,130,63050,241,469,0.513859275
129,494,623,252,84,168,376,326,122576,47,142,0.330985915
341,232,573,431,373,58,266,472,125552,441,253,1.743083004
64,13,77,493,234,259,260,266,69160,219,349,0.627507163
364,232,596,281,228,53,382,412,157384,329,367,0.896457766
238,85,323,76,450,-374,194,395,76630,340,399,0.852130326
409,500,909,281,114,167,229,386,88394,76,151,0.503311258
308,211,519,107,476,-369,131,23,3013,284,19,14.94736842
134,293,427,427,389,38,386,348,134328,123,87,1.413793103
144,382,526,488,398,90,19,461,8759,251,184,1.364130435
141,421,562,361,421,-60,409,257,105113,49,455,0.107692308
329,253,582,56,169,-113,29,251,7279,385,224,1.71875
210,264,474,117,199,-82,411,156,64116,179,74,2.418918919
108,487,595,144,16,128,209,444,92796,280,359,0.77994429
147,260,407,122,465,-343,465,133,61845,338,196,1.724489796
73,423,496,401,227,174,389,315,122535,371,207,1.792270531
364,149,513,428,367,61,489,282,137898,187,121,1.545454545
488,284,772,101,12,89,294,74,21756,312,101,3.089108911
434,462,896,180,63,117,348,90,31320,44,432,0.101851852
340,21,361,416,368,48,280,64,17920,81,132,0.613636364
291,225,516,347,470,-123,92,120,11040,396,380,1.042105263
239,33,272,443,266,177,46,58,2668,442,161,2.745341615
251,432,683,342,117,225,493,371,182903,326,451,0.722838137
285,91,376,461,440,21,107,296,31672,91,13,7
197,253,450,185,97,88,138,45,6210,408,237,1.721518987
347,464,811,211,216,-5,188,477,89676,494,480,1.029166667
22,376,398,434,138,296,239,109,26051,350,455,0.769230769
192,17,209,243,472,-229,290,394,114260,321,336,0.955357143
161,446,607,224,255,-31,445,49,21805,463,157,2.949044586
98,29,127,206,400,-194,442,90,39780,343,116,2.956896552
211,173,384,156,230,-74,116,338,39208,209,384,0.544270833
473,241,714,47,130,-83,217,410,88970,325,269,1.208178439
429,435,864,348,403,-55,295,461,135995,14,43,0.325581395
346,186,532,458,395,63,473,310,146630,355,319,1.112852665
237,287,524,11,311,-300,97,376,36472,207,417,0.496402878
323,65,388,355,490,-135,397,413,163961,140,356,0.393258427
398,410,808,49,363,-314,261,394,102834,52,83,0.626506024
31,123,154,302,330,-28,169,190,32110,381,307,1.241042345
202,352,554,326,155,171,26,233,6058,354,400,0.885
320,216,536,64,110,-46,80,223,17840,175,485,0.360824742
500,13,513,282,253,29,53,133,7049,288,464,0.620689655
148,279,427,237,295,-58,258,469,121002,444,497,0.893360161
91,201,292,370,129,241,228,327,74556,434,265,1.637735849
207,12,219,323,138,185,396,450,178200,266,99,2.686868687
416,249,665,65,382,-317,182,255,46410,225,247,0.910931174
329,206,535,344,92,252,154,224,34496,117,18,6.5
255,410,665,12,271,-259,224,479,107296,324,138,2.347826087
313,237,550,209,125,84,57,299,17043,409,55,7.436363636
380,419,799,40,366,-326,141,402,56682,265,101,2.623762376
12,484,496,358,334,24,53,58,3074,258,136,1.897058824
196,461,657,81,37,44,390,138,53820,218,246,0.886178862
368,179,547,256,399,-143,210,292,61320,420,462,0.909090909
87,150,237,30,158,-128,126,200,25200,454,474,0.957805907
168,353,521,344,407,-63,349,369,128781,497,236,2.105932203
415,383,798,178,70,108,240,243,58320,467,431,1.083526682
489,471,960,300,452,-152,86,420,36120,273,98,2.785714286
60,358,418,168,186,-18,196,32,6272,12,426,0.028169014
277,79,356,199,266,-67,308,100,30800,305,20,15.25
318,100,418,19,83,-64,142,410,58220,346,160,2.1625
223,444,667,471,373,98,59,497,29323,488,82,5.951219512
92,219,311,63,137,-74,16,234,3744,437,405,1.079012346
102,496,598,358,143,215,40,126,5040,395,54,7.314814815
64,85,149,108,199,-91,298,114,33972,485,188,2.579787234
480,219,699,52,483,-431,437,58,25346,440,109,4.036697248
49,421,470,268,374,-106,380,322,122360,111,367,0.302452316
389,130,519,332,489,-157,255,313,79815,157,34,4.617647059
323,101,424,293,360,-67,481,497,239057,475,353,1.345609065
404,152,556,465,222,243,69,181,12489,253,65,3.892307692
417,60,477,103,164,-61,424,68,28832,405,139,2.913669065
322,87,409,70,61,9,461,311,143371,162,498,0.325301205
232,63,295,92,160,-68,22,414,9108,52,95,0.547368421
69,455,524,22,162,-140,412,220,90640,83,484,0.171487603
105,65,170,261,471,-210,261,53,13833,58,428,0.135514019
391,409,800,464,369,95,295,214,63130,174,141,1.234042553
157,401,558,363,141,222,286,398,113828,351,397,0.884130982
418,194,612,314,443,-129,276,400,110400,252,89,2.831460674
272,421,693,139,289,-150,148,39,5772,43,88,0.488636364
399,213,612,312,132,180,166,298,49468,181,192,0.942708333
129,274,403,437,55,382,396,179,70884,26,239,0.108786611
110,81,191,139,118,21,214,45,9630,54,423,0.127659574
450,348,798,243,332,-89,31,10,310,314,112,2.803571429
267,357,624,42,229,-187,39,392,15288,151,147,1.027210884
179,441,620,443,216,227,396,10,3960,361,28,12.89285714
133,444,577,89,415,-326,401,139,55739,363,449,0.808463252
102,275,377,175,482,-307,134,422,56548,303,500,0.606
141,467,608,348,116,232,243,372,90396,474,388,1.221649485
230,236,466,429,168,261,354,320,113280,147,120,1.225
387,346,733,318,405,-87,371,40,14840,70,370,0.189189189
361,95,456,96,385,-289,384,236,90624,239,387,0.617571059
461,394,855,126,236,-110,300,143,42900,256,224,1.142857143
495,277,772,57,104,-47,398,137,54526,28,360,0.077777778
333,242,575,96,310,-214,215,242,52030,190,168,1.130952381
126,299,425,408,129,279,401,498,199698,271,132,2.053030303
316,77,393,490,207,283,427,401,171227,259,190,1.363157895
39,222,261,303,153,150,343,409,140287,78,83,0.939759036
442,83,525,439,217,222,364,230,83720,10,291,0.034364261
101,381,482,289,260,29,113,61,6893,306,143,2.13986014
490,99,589,99,446,-347,433,181,78373,395,446,0.885650224
180,65,245,446,168,278,378,365,137970,355,276,1.286231884
137,445,582,81,488,-407,292,107,31244,422,445,0.948314607
388,460,848,287,447,-160,356,170,60520,150,196,0.765306122
124,474,598,290,203,87,252,111,27972,105,199,0.527638191
154,321,475,11,51,-40,335,97,32495,29,186,0.155913978
75,473,548,78,442,-364,240,344,82560,60,270,0.222222222
277,427,704,175,149,26,410,150,61500,392,116,3.379310345
455,366,821,383,311,72,62,435,26970,471,302,1.559602649
329,53,382,429,24,405,180,356,64080,216,387,0.558139535
248,445,693,45,305,-260,487,81,39447,237,243,0.975308642
200,90,290,181,259,-78,164,434,71176,122,60,2.033333333
123,431,554,447,122,325,84,64,5376,67,189,0.354497354
410,300,710,343,166,177,17,115,1955,63,102,0.617647059
13,365,378,70,450,-380,429,246,105534,237,409,0.579462103
189,219,408,443,116,327,486,275,133650,78,351,0.222222222
386,134,520,386,293,93,328,366,120048,249,35,7.114285714
146,407,553,306,156,150,491,121,59411,320,460,0.695652174
434,322,756,463,493,-30,481,81,38961,460,107,4.299065421
351,257,608,480,173,307,292,60,17520,238,406,0.586206897
149,371,520,365,281,84,120,319,38280,403,60,6.716666667
438,222,660,115,403,-288,158,486,76788,284,129,2.201550388
365,435,800,129,383,-254,454,431,195674,331,169,1.958579882
271,412,683,178,213,-35,23,199,4577,307,436,0.70412844
149,363,512,100,384,-284,327,238,77826,102,133,0.766917293
383,329,712,290,347,-57,70,383,26810,233,216,1.078703704
205,222,427,218,198,20,477,143,68211,402,227,1.77092511
362,458,820,36,225,-189,254,402,102108,281,237,1.185654008
441,402,843,387,231,156,178,475,84550,260,67,3.880597015
389,11,400,336,230,106,260,238,61880,133,127,1.047244094
405,392,797,37,208,-171,204,196,39984,465,421,1.104513064
143,227,370,345,190,155,385,102,39270,274,370,0.740540541
490,316,806,500,210,290,468,174,81432,299,335,0.892537313
186,321,507,218,137,81,333,183,60939,463,384,1.205729167
428,176,604,217,184,33,366,44,16104,313,401,0.780548628
449,339,788,321,222,99,134,310,41540,275,17,16.17647059
437,262,699,324,161,163,321,175,56175,216,40,5.4
399,361,760,464,261,203,324,168,54432,339,483,0.701863354
457,233,690,211,135,76,220,316,69520,467,44,10.61363636
57,480,537,355,15,340,202,210,42420,264,152,1.736842105
386,376,762,353,237,116,375,454,170250,484,68,7.117647059
243,378,621,361,189,172,357,305,108885,390,125,3.12
320,471,791,228,195,33,428,321,137388,492,161,3.055900621
286,266,552,149,402,-253,424,153,64872,214,243,0.880658436
86,411,497,385,263,122,26,87,2262,486,481,1.01039501
21,150,171,204,307,-103,103,51,5253,373,171,2.18128655
310,217,527,369,396,-27,192,387,74304,129,242,0.533057851
410,309,719,296,65,231,229,145,33205,474,468,1.012820513
208,407,615,149,317,-168,121,392,47432,496,91,5.450549451
226,84,310,120,490,-370,104,197,20488,356,30,11.86666667
17,380,397,273,226,47,428,171,73188,279,118,2.36440678
353,409,762,290,33,257,351,333,116883,325,300,1.083333333
421,29,450,155,446,-291,408,470,191760,45,46,0.97826087
132,343,475,460,78,382,425,118,50150,300,454,0.660792952
143,23,166,463,182,281,95,462,43890,72,106,0.679245283
64,448,512,33,17,16,320,181,57920,181,95,1.905263158
121,202,323,244,100,144,326,122,39772,461,113,4.079646018
263,108,371,177,345,-168,153,167,25551,373,225,1.657777778
475,374,849,213,302,-89,422,375,158250,105,492,0.213414634
318,99,417,50,208,-158,280,262,73360,453,175,2.588571429
235,244,479,268,494,-226,377,354,133458,11,327,0.033639144
95,86,181,336,107,229,81,97,7857,36,268,0.134328358
261,412,673,450,96,354,151,185,27935,170,208,0.817307692
157,66,223,412,37,375,152,432,65664,213,493,0.432048682
209,43,252,118,183,-65,227,21,4767,178,40,4.45
410,368,778,259,497,-238,221,193,42653,423,337,1.255192878
124,431,555,355,77,278,379,91,34489,15,413,0.036319613
91,255,346,17,167,-150,497,314,156058,166,398,0.417085427
152,260,412,358,247,111,115,334,38410,344,158,2.17721519
439,398,837,311,239,72,96,175,16800,282,88,3.204545455
23,348,371,159,490,-331,180,293,52740,233,134,1.73880597
92,67,159,347,209,138,123,312,38376,116,167,0.694610778
257,319,576,59,335,-276,251,29,7279,136,154,0.883116883
366,211,577,382,105,277,400,407,162800,446,192,2.322916667
413,365,778,435,133,302,330,91,30030,447,247,1.809716599
133,218,351,108,97,11,337,184,62008,349,293,1.19112628
295,139,434,54,282,-228,45,246,11070,298,90,3.311111111
498,454,952,309,322,-13,348,381,132588,253,177,1.429378531
183,378,561,360,212,148,67,364,24388,201,216,0.930555556
80,141,221,220,293,-73,175,282,49350,240,84,2.857142857
478,392,870,144,342,-198,93,125,11625,333,33,10.09090909
140,24,164,314,429,-115,297,20,5940,114,53,2.150943396
111,268,379,228,51,177,133,288,38304,53,122,0.43442623
29,226,255,117,55,62,469,424,198856,381,407,0.936117936
490,384,874,371,194,177,391,239,93449,406,322,1.260869565
278,469,747,451,492,-41,332,52,17264,263,483,0.544513458
342,192,534,267,435,-168,413,344,142072,81,416,0.194711538
34,225,259,219,348,-129,253,275,69575,226,52,4.346153846
115,333,448,413,260,153,49,466,22834,278,44,6.318181818
271,219,490,475,132,343,439,264,115896,239,119,2.008403361
410,57,467,67,97,-30,256,34,8704,221,155,1.425806452
127,178,305,34,207,-173,132,322,42504,197,197,1
266,234,500,259,313,-54,207,262,54234,434,160,2.7125
126,36,162,38,220,-182,146,345,50370,256,493,0.519269777
176,76,252,183,281,-98,442,259,114478,227,292,0.77739726
362,461,823,340,76,264,121,67,8107,338,395,0.855696203
163,428,591,293,298,-5,455,249,113295,202,36,5.611111111
385,53,438,349,42,307,93,337,31341,53,64,0.828125
281,223,504,404,175,229,430,322,138460,146,250,0.584
262,452,714,126,253,-127,387,336,130032,54,434,0.124423963
75,260,335,405,240,165,299,38,11362,119,305,0.390163934
90,318,408,147,166,-19,94,410,38540,447,284,1.573943662
243,21,264,60,321,-261,44,375,16500,269,248,1.084677419
19,60,79,451,138,313,372,189,70308,47,219,0.214611872
287,362,649,159,53,106,45,89,4005,89,456,0.195175439
201,134,335,21,59,-38,54,165,8910,155,94,1.64893617
406,386,792,164,437,-273,103,282,29046,292,391,0.746803069
263,360,623,363,435,-72,231,441,101871,248,147,1.68707483
207,475,682,139,73,66,191,108,20628,191,370,0.516216216
152,208,360,15,296,-281,228,414,94392,101,203,0.497536946
119,52,171,54,470,-416,333,426,141858,198,137,1.445255474
411,230,641,57,73,-16,40,261,10440,223,288,0.774305556
231,238,469,270,209,61,181,156,28236,231,196,1.178571429
356,120,476,86,378,-292,133,120,15960,444,307,1.446254072
346,107,453,61,121,-60,330,420,138600,339,424,0.799528302
354,412,766,78,62,16,353,444,156732,392,71,5.521126761
134,371,505,401,109,292,492,164,80688,484,341,1.419354839
302,383,685,145,486,-341,108,400,43200,211,238,0.886554622
151,369,520,273,257,16,377,297,111969,336,410,0.819512195
156,387,543,189,348,-159,214,206,44084,414,399,1.037593985
118,165,283,196,55,141,488,381,185928,264,122,2.163934426
253,137,390,46,295,-249,454,480,217920,298,57,5.228070175
133,182,315,490,75,415,394,57,22458,207,177,1.169491525
211,319,530,144,52,92,21,158,3318,277,213,1.300469484
375,187,562,217,324,-107,367,285,104595,26,208,0.125
329,27,356,51,283,-232,490,64,31360,373,374,0.997326203
110,370,480,163,279,-116,401,345,138345,402,141,2.85106383
109,482,591,35,367,-332,314,418,131252,205,272,0.753676471
256,411,667,419,407,12,439,131,57509,354,394,0.898477157
